"","Names","Gender","2015 Count","2016 Count","Total"
"1","Emma","F","20415","19414",39829
"2","Olivia","F","19638","19246",38884
"3","Sophia","F","17381","16070",33451
"4","Ava","F","16340","16237",32577
"5","Isabella","F","15574","14722",30296
"6","Mia","F","14871","14366",29237
"9","Charlotte","F","11381","13030",24411
"7","Abigail","F","12371","11699",24070
"8","Emily","F","11766","10926",22692
"10","Harper","F","10283","10733",21016
