"","Names","Gender","2015 Count","2016 Count","Total"
"1","Emma","F","20415","19414",39829
"2","Olivia","F","19638","19246",38884
"3","Sophia","F","17381","16070",33451
"4","Ava","F","16340","16237",32577
"5","Isabella","F","15574","14722",30296
"6","Mia","F","14871","14366",29237
"9","Charlotte","F","11381","13030",24411
"7","Abigail","F","12371","11699",24070
"8","Emily","F","11766","10926",22692
"10","Harper","F","10283","10733",21016
"12","Amelia","F","9838","10702",20540
"15","Evelyn","F","9352","10060",19412
"13","Elizabeth","F","9703","9493",19196
"11","Madison","F","10072","8982",19054
"14","Sofia","F","9681","9134",18815
"16","Avery","F","9330","8733",18063
"18","Ella","F","7882","7866",15748
"17","Chloe","F","7907","7410",15317
"19","Grace","F","7630","7531",15161
"20","Victoria","F","7600","7267",14867
"22","Scarlett","F","7121","7680",14801
"21","Aubrey","F","7376","6507",13883
"23","Zoey","F","6927","6414",13341
"29","Aria","F","6392","6904",13296
"25","Lily","F","6644","6558",13202
"24","Addison","F","6706","6295",13001
"26","Lillian","F","6597","6333",12930
"35","Riley","F","5720","7110",12830
"27","Natalie","F","6490","6156",12646
"30","Layla","F","6314","6234",12548
"28","Hannah","F","6398","5976",12374
"34","Penelope","F","5936","6367",12303
"31","Brooklyn","F","6291","5922",12213
"33","Zoe","F","6032","5706",11738
"42","Camila","F","5271","6036",11307
"36","Leah","F","5606","5380",10986
"37","Audrey","F","5600","5330",10930
"41","Nora","F","5314","5561",10875
"32","Alexa","F","6049","4760",10809
"38","Savannah","F","5437","5336",10773
"43","Skylar","F","5271","5099",10370
"40","Samantha","F","5331","4924",10255
"39","Allison","F","5342","4762",10104
"49","Claire","F","4823","5190",10013
"45","Paisley","F","5069","4839",9908
"47","Ellie","F","4855","5045",9900
"44","Anna","F","5119","4749",9868
"51","Stella","F","4786","4912",9698
"50","Violet","F","4805","4837",9642
"53","Mila","F","4724","4802",9526
"60","Eleanor","F","4424","5100",9524
"46","Ariana","F","4944","4577",9521
"48","Aaliyah","F","4850","4611",9461
"55","Lucy","F","4538","4568",9106
"52","Sadie","F","4741","4264",9005
"63","Hazel","F","4288","4634",8922
"58","Sarah","F","4507","4378",8885
"57","Kennedy","F","4512","4313",8825
"54","Gabriella","F","4606","4215",8821
"62","Caroline","F","4322","4410",8732
"59","Madelyn","F","4478","4208",8686
"65","Genesis","F","4157","4325",8482
"56","Arianna","F","4519","3869",8388
"61","Kaylee","F","4362","3814",8176
"68","Maya","F","4115","4055",8170
"64","Hailey","F","4236","3918",8154
"69","Autumn","F","4108","3990",8098
"67","Piper","F","4122","3926",8048
"71","Serenity","F","3966","3789",7755
"70","Nevaeh","F","3979","3756",7735
"78","Aurora","F","3632","3963",7595
"66","Kylie","F","4149","3396",7545
"75","Eva","F","3756","3777",7533
"76","Naomi","F","3750","3772",7522
"74","Bella","F","3778","3641",7419
"72","Peyton","F","3895","3482",7377
"83","Ruby","F","3454","3796",7250
"73","Mackenzie","F","3850","3390",7240
"80","Lydia","F","3491","3590",7081
"86","Alice","F","3412","3669",7081
"79","Aubree","F","3622","3390",7012
"77","Taylor","F","3741","3261",7002
"81","Melanie","F","3490","3473",6963
"88","Cora","F","3397","3350",6747
"97","Quinn","F","3089","3636",6725
"84","Katherine","F","3442","3259",6701
"89","Julia","F","3369","3310",6679
"90","Madeline","F","3327","3257",6584
"82","Brianna","F","3464","3076",6540
"135","Adeline","F","2403","4103",6506
"85","Ashley","F","3419","3024",6443
"110","Luna","F","2796","3645",6441
"96","Gianna","F","3170","3209",6379
"91","Faith","F","3305","3035",6340
"95","Vivian","F","3197","3124",6321
"92","Annabelle","F","3262","2974",6236
"94","Isabelle","F","3213","3008",6221
"102","Eliana","F","2973","3185",6158
"99","Reagan","F","3047","3081",6128
"113","Kinsley","F","2771","3353",6124
"98","Clara","F","3058","3055",6113
"87","Alexis","F","3406","2662",6068
"106","Elena","F","2886","3168",6054
"93","Alyssa","F","3242","2662",5904
"112","Willow","F","2793","3086",5879
"103","Hadley","F","2970","2871",5841
"100","Alexandra","F","2998","2831",5829
"104","Sophie","F","2931","2851",5782
"114","Valentina","F","2745","2908",5653
"121","Rylee","F","2678","2947",5625
"109","Maria","F","2819","2788",5607
"108","Bailey","F","2833","2689",5522
"101","Khloe","F","2993","2520",5513
"118","Natalia","F","2692","2813",5505
"116","Delilah","F","2721","2715",5436
"111","Jasmine","F","2793","2625",5418
"130","Ivy","F","2498","2797",5295
"125","Ximena","F","2598","2673",5271
"131","Josephine","F","2495","2766",5261
"105","London","F","2909","2339",5248
"126","Jade","F","2559","2685",5244
"145","Emilia","F","2215","3019",5234
"124","Adalynn","F","2614","2585",5199
"138","Everly","F","2324","2873",5197
"115","Kayla","F","2730","2456",5186
"128","Brielle","F","2530","2651",5181
"127","Liliana","F","2556","2624",5180
"117","Andrea","F","2702","2473",5175
"107","Kimberly","F","2836","2321",5157
"123","Mary","F","2620","2487",5107
"120","Morgan","F","2680","2319",4999
"119","Lauren","F","2686","2311",4997
"122","Sydney","F","2653","2309",4962
"134","Emery","F","2415","2410",4825
"141","Isla","F","2270","2504",4774
"129","Trinity","F","2503","2215",4718
"132","Adalyn","F","2452","2176",4628
"133","Jocelyn","F","2447","2088",4535
"137","Ariel","F","2339","2177",4516
"142","Lyla","F","2266","2209",4475
"136","Jordyn","F","2368","2092",4460
"139","Lilly","F","2297","2132",4429
"140","Paige","F","2287","2041",4328
"154","Margaret","F","2103","2202",4305
"148","Melody","F","2173","2128",4301
"149","Isabel","F","2156","2100",4256
"143","Molly","F","2249","1977",4226
"157","Athena","F","2046","2162",4208
"144","Makayla","F","2248","1918",4166
"156","Eden","F","2060","2068",4128
"151","Mckenzie","F","2124","1982",4106
"146","Mya","F","2196","1902",4098
"152","Nicole","F","2108","1941",4049
"159","Norah","F","2026","2016",4042
"161","Valeria","F","1977","2031",4008
"150","Brooke","F","2146","1856",4002
"155","Mariah","F","2097","1905",4002
"162","Sara","F","1971","2024",3995
"163","Aliyah","F","1964","1993",3957
"166","Rose","F","1938","2016",3954
"153","Payton","F","2106","1793",3899
"147","Kendall","F","2191","1694",3885
"158","Amy","F","2037","1828",3865
"168","Juliana","F","1901","1944",3845
"160","Londyn","F","2018","1811",3829
"171","Valerie","F","1877","1949",3826
"169","Laila","F","1884","1937",3821
"164","Angelina","F","1963","1843",3806
"214","Nova","F","1518","2272",3790
"167","Rachel","F","1922","1854",3776
"178","Raelynn","F","1797","1971",3768
"179","Leilani","F","1794","1959",3753
"174","Elise","F","1841","1905",3746
"165","Gracie","F","1946","1799",3745
"180","Emerson","F","1789","1947",3736
"175","Eliza","F","1828","1851",3679
"172","Alina","F","1855","1814",3669
"173","Reese","F","1853","1815",3668
"181","Cecilia","F","1776","1814",3590
"176","Alaina","F","1817","1760",3577
"198","Ryleigh","F","1655","1877",3532
"170","Brooklynn","F","1882","1649",3531
"201","Arya","F","1639","1890",3529
"182","Genevieve","F","1771","1723",3494
"183","Daisy","F","1763","1717",3480
"229","Teagan","F","1435","2034",3469
"177","Catherine","F","1799","1660",3459
"184","Harmony","F","1745","1703",3448
"203","Esther","F","1614","1789",3403
"196","Arabella","F","1674","1723",3397
"185","Vanessa","F","1726","1654",3380
"194","Adelyn","F","1677","1659",3336
"204","Finley","F","1601","1719",3320
"187","Presley","F","1720","1595",3315
"208","Charlie","F","1557","1751",3308
"200","Daniela","F","1641","1663",3304
"191","Julianna","F","1706","1597",3303
"189","Destiny","F","1712","1573",3285
"188","Rebecca","F","1718","1563",3281
"190","Hayden","F","1708","1569",3277
"193","Summer","F","1678","1590",3268
"192","Michelle","F","1699","1559",3258
"217","Iris","F","1499","1736",3235
"186","Adriana","F","1723","1489",3212
"195","Callie","F","1677","1531",3208
"199","Lila","F","1650","1549",3199
"216","Anastasia","F","1499","1694",3193
"202","Alana","F","1616","1564",3180
"213","Amaya","F","1525","1571",3096
"225","Juliette","F","1449","1646",3095
"219","Fiona","F","1492","1547",3039
"205","Gabrielle","F","1597","1410",3007
"212","Alexandria","F","1529","1460",2989
"220","Angela","F","1485","1503",2988
"218","Marley","F","1493","1491",2984
"215","Alivia","F","1517","1452",2969
"211","Ana","F","1540","1425",2965
"226","Lucia","F","1449","1511",2960
"206","Jessica","F","1582","1375",2957
"221","Giselle","F","1484","1457",2941
"209","Tessa","F","1554","1385",2939
"207","Stephanie","F","1558","1366",2924
"227","Parker","F","1442","1470",2912
"223","Alayna","F","1456","1431",2887
"222","Kate","F","1474","1382",2856
"210","Makenzie","F","1545","1299",2844
"230","Georgia","F","1433","1405",2838
"224","Lola","F","1450","1372",2822
"254","Eloise","F","1261","1554",2815
"228","Sienna","F","1436","1365",2801
"365","Adaline","F","902","1873",2775
"238","Jayla","F","1382","1377",2759
"231","Hope","F","1433","1324",2757
"244","Brynlee","F","1317","1428",2745
"240","Juliet","F","1353","1391",2744
"236","Daleyza","F","1395","1346",2741
"241","Dakota","F","1330","1405",2735
"233","Vivienne","F","1426","1275",2701
"247","Leila","F","1303","1383",2686
"197","Kaitlyn","F","1656","994",2650
"235","Kinley","F","1405","1243",2648
"242","Maggie","F","1328","1312",2640
"250","Josie","F","1284","1352",2636
"234","Izabella","F","1410","1216",2626
"232","Cali","F","1430","1194",2624
"246","Camille","F","1306","1300",2606
"281","Harley","F","1127","1422",2549
"248","Mckenna","F","1299","1245",2544
"260","Evangeline","F","1219","1324",2543
"251","Noelle","F","1282","1260",2542
"243","Delaney","F","1325","1198",2523
"253","Melissa","F","1276","1228",2504
"255","Gabriela","F","1259","1243",2502
"261","Sawyer","F","1219","1272",2491
"237","Kylee","F","1388","1073",2461
"249","Aniyah","F","1296","1159",2455
"259","Brynn","F","1224","1231",2455
"252","Jennifer","F","1281","1153",2434
"269","Gemma","F","1169","1264",2433
"266","Rosalie","F","1187","1241",2428
"265","Ayla","F","1199","1226",2425
"273","Adelaide","F","1157","1227",2384
"263","Paris","F","1212","1152",2364
"268","Maci","F","1177","1185",2362
"264","Olive","F","1205","1155",2360
"258","Jacqueline","F","1229","1130",2359
"257","Cassidy","F","1231","1113",2344
"274","Journey","F","1149","1193",2342
"245","Keira","F","1310","1030",2340
"331","Rowan","F","985","1344",2329
"262","Jordan","F","1212","1113",2325
"301","Elliana","F","1068","1257",2325
"305","Joanna","F","1059","1263",2322
"280","June","F","1131","1180",2311
"270","Lilliana","F","1169","1126",2295
"271","Raegan","F","1165","1129",2294
"272","Lena","F","1160","1134",2294
"256","Allie","F","1257","1035",2292
"304","Amiyah","F","1060","1228",2288
"291","Elaina","F","1101","1184",2285
"278","Miranda","F","1134","1135",2269
"296","Diana","F","1084","1178",2262
"267","Kali","F","1183","1078",2261
"276","Adelynn","F","1138","1123",2261
"314","Malia","F","1027","1227",2254
"239","Katelyn","F","1380","864",2244
"288","Jane","F","1111","1129",2240
"284","Lucille","F","1115","1122",2237
"290","Lyric","F","1107","1128",2235
"282","Charlee","F","1122","1094",2216
"277","Alessandra","F","1137","1066",2203
"294","Miriam","F","1098","1100",2198
"295","Mariana","F","1086","1106",2192
"327","Sloane","F","998","1184",2182
"292","Ruth","F","1099","1081",2180
"283","Talia","F","1119","1052",2171
"303","Amina","F","1061","1100",2161
"320","Paislee","F","1009","1130",2139
"285","Phoebe","F","1115","1021",2136
"279","Haley","F","1133","999",2132
"287","Makenna","F","1113","1017",2130
"321","Selena","F","1009","1119",2128
"275","Kenzie","F","1139","984",2123
"299","Nina","F","1075","1041",2116
"323","Annie","F","1002","1113",2115
"313","Lilah","F","1027","1082",2109
"289","Angel","F","1107","1001",2108
"309","Vera","F","1050","1052",2102
"312","Fatima","F","1042","1059",2101
"356","Blakely","F","918","1173",2091
"329","Haven","F","991","1098",2089
"308","Lexi","F","1050","1019",2069
"297","Danielle","F","1083","984",2067
"349","River","F","945","1118",2063
"300","Shelby","F","1072","978",2050
"293","Adrianna","F","1098","947",2045
"311","Maddison","F","1047","979",2026
"326","Catalina","F","999","1024",2023
"315","Madilyn","F","1022","999",2021
"286","Skyler","F","1114","905",2019
"302","Madeleine","F","1065","947",2012
"316","Amanda","F","1020","992",2012
"335","Addilyn","F","972","1033",2005
"318","Daniella","F","1015","984",1999
"352","Arielle","F","928","1068",1996
"325","Nyla","F","1000","993",1993
"341","Raelyn","F","961","1024",1985
"306","Chelsea","F","1054","928",1982
"330","Lia","F","991","980",1971
"328","Kamila","F","994","974",1968
"298","Jenna","F","1080","883",1963
"322","Laura","F","1005","958",1963
"324","Kayleigh","F","1000","951",1951
"310","Katie","F","1049","885",1934
"351","Heaven","F","940","993",1933
"338","Alison","F","964","966",1930
"339","Ainsley","F","963","963",1926
"342","Kendra","F","960","954",1914
"366","Ember","F","895","1009",1904
"394","Emersyn","F","827","1068",1895
"336","Erin","F","969","920",1889
"307","Jada","F","1052","829",1881
"317","Alexia","F","1016","865",1881
"357","Ada","F","916","959",1875
"337","Myla","F","969","892",1861
"346","Nadia","F","948","908",1856
"377","Journee","F","865","986",1851
"388","Rylie","F","844","1003",1847
"374","Camilla","F","870","972",1842
"423","Blake","F","751","1091",1842
"319","Kathryn","F","1012","829",1841
"334","Amber","F","973","865",1838
"343","Heidi","F","953","885",1838
"354","Gracelyn","F","919","909",1828
"340","Cadence","F","962","864",1826
"361","Felicity","F","906","917",1823
"402","Zara","F","805","1018",1823
"386","Elsie","F","846","974",1820
"333","Christina","F","975","841",1816
"332","Ashlyn","F","981","830",1811
"360","Briella","F","907","904",1811
"369","Sage","F","882","928",1810
"344","Kelsey","F","949","853",1802
"460","Thea","F","688","1113",1801
"358","Kyla","F","915","882",1797
"355","Sabrina","F","919","874",1793
"400","Ariella","F","812","981",1793
"348","Kaydence","F","945","845",1790
"347","Alondra","F","945","843",1788
"363","Kira","F","905","876",1781
"372","Aspen","F","874","896",1770
"362","Kamryn","F","906","861",1767
"421","Leia","F","762","1005",1767
"458","Amara","F","689","1078",1767
"364","Alicia","F","904","859",1763
"408","Brinley","F","784","979",1763
"350","Mikayla","F","943","819",1762
"353","Lana","F","920","841",1761
"416","Freya","F","766","991",1757
"345","Cheyenne","F","948","802",1750
"370","Esmeralda","F","880","864",1744
"373","Gia","F","873","868",1741
"376","Scarlet","F","868","862",1730
"501","Remi","F","633","1095",1728
"380","Amira","F","857","867",1724
"391","Gracelynn","F","836","871",1707
"381","Bianca","F","857","849",1706
"368","Veronica","F","889","801",1690
"392","Logan","F","833","852",1685
"371","Leslie","F","878","801",1679
"429","Juniper","F","740","939",1679
"359","Allyson","F","907","770",1677
"382","Carmen","F","855","820",1675
"378","Daphne","F","864","809",1673
"433","Joy","F","727","941",1668
"399","Kiara","F","813","850",1663
"367","Aylin","F","893","761",1654
"398","Dylan","F","814","837",1651
"514","Ariah","F","607","1040",1647
"389","Carly","F","842","802",1644
"384","Skye","F","855","788",1643
"397","Elle","F","816","825",1641
"387","Kennedi","F","846","794",1640
"395","Camryn","F","823","815",1638
"375","Ashlynn","F","869","759",1628
"414","Miracle","F","770","856",1626
"406","Anaya","F","788","836",1624
"390","Averie","F","839","782",1621
"403","April","F","801","820",1621
"404","Gwendolyn","F","791","824",1615
"379","Mckinley","F","858","755",1613
"412","Dahlia","F","774","839",1613
"443","Zuri","F","712","884",1596
"409","Annalise","F","779","816",1595
"385","Megan","F","850","743",1593
"448","Kaia","F","702","879",1581
"420","Helen","F","762","813",1575
"393","Mallory","F","832","735",1567
"396","Annabella","F","817","746",1563
"441","Evelynn","F","718","843",1561
"405","Sierra","F","790","757",1547
"411","Tatum","F","778","765",1543
"422","Harlow","F","757","781",1538
"453","Jimena","F","693","827",1520
"439","Nylah","F","720","795",1515
"451","Maeve","F","699","816",1515
"428","Francesca","F","744","762",1506
"430","Carolina","F","732","769",1501
"383","Kyleigh","F","855","641",1496
"410","Serena","F","778","716",1494
"401","Yaretzi","F","808","677",1485
"466","Braelynn","F","682","803",1485
"419","Briana","F","763","719",1482
"434","Maliyah","F","727","754",1481
"424","Jayleen","F","750","716",1466
"427","Viviana","F","745","718",1463
"418","Bethany","F","763","687",1450
"437","Abby","F","721","724",1445
"442","Nia","F","715","730",1445
"415","Madelynn","F","768","669",1437
"417","Macie","F","764","672",1436
"432","Jazmin","F","729","705",1434
"470","Leighton","F","678","754",1432
"465","Luciana","F","683","736",1419
"449","Alejandra","F","701","717",1418
"407","Baylee","F","788","626",1414
"447","Lorelei","F","703","711",1414
"454","Phoenix","F","693","719",1412
"474","Millie","F","677","735",1412
"444","Aleah","F","709","697",1406
"436","Malaysia","F","722","683",1405
"413","Macy","F","772","628",1400
"512","Evie","F","611","784",1395
"456","Marlee","F","692","699",1391
"445","Addyson","F","708","677",1385
"431","Emely","F","731","649",1380
"472","Eve","F","677","698",1375
"426","Marilyn","F","746","628",1374
"476","Amari","F","675","695",1370
"457","Nayeli","F","691","670",1361
"440","Sarai","F","719","641",1360
"452","Justice","F","698","662",1360
"425","Angelica","F","749","609",1358
"475","Ryan","F","677","680",1357
"468","Selah","F","682","672",1354
"480","Willa","F","672","682",1354
"473","Janelle","F","677","663",1340
"517","Regina","F","604","733",1337
"455","Julie","F","692","644",1336
"518","Rosemary","F","604","729",1333
"506","Zariah","F","621","711",1332
"435","Cataleya","F","723","606",1329
"515","Frances","F","607","716",1323
"471","Aubrie","F","677","645",1322
"469","Braelyn","F","680","640",1320
"438","Jillian","F","721","597",1318
"495","Michaela","F","646","669",1315
"463","Karina","F","687","626",1313
"481","Lacey","F","671","634",1305
"491","Itzel","F","651","654",1305
"467","Kassidy","F","682","617",1299
"461","Aleena","F","687","611",1298
"502","Priscilla","F","631","666",1297
"446","Bristol","F","705","585",1290
"487","Elisa","F","654","628",1282
"450","Jazmine","F","700","578",1278
"490","Raven","F","652","626",1278
"537","Carter","F","579","699",1278
"459","Emmalyn","F","689","585",1274
"477","Brylee","F","675","599",1274
"479","Kelly","F","673","601",1274
"527","Liana","F","594","680",1274
"484","Sylvia","F","658","614",1272
"488","Hattie","F","653","616",1269
"661","Aviana","F","430","839",1269
"492","Aisha","F","649","617",1266
"529","Colette","F","593","672",1265
"497","Celeste","F","638","625",1263
"498","Jamie","F","638","621",1259
"462","Brittany","F","687","570",1257
"516","Lennon","F","605","649",1254
"478","Madisyn","F","675","575",1250
"592","Margot","F","505","742",1247
"464","Giuliana","F","684","561",1245
"508","Kara","F","619","622",1241
"505","Karen","F","625","614",1239
"489","Holly","F","653","585",1238
"499","Madilynn","F","638","597",1235
"561","Fernanda","F","551","684",1235
"524","Edith","F","596","631",1227
"528","Alani","F","593","634",1227
"504","Jazlyn","F","626","599",1225
"493","Kyra","F","648","568",1216
"530","Charleigh","F","591","620",1211
"483","Jaylah","F","664","543",1207
"485","Melany","F","657","550",1207
"520","Danna","F","601","605",1206
"507","Lauryn","F","620","585",1205
"608","Saylor","F","478","727",1205
"535","Matilda","F","581","623",1204
"494","Tiffany","F","648","555",1203
"503","Savanna","F","628","570",1198
"523","Virginia","F","598","599",1197
"545","Adelina","F","569","624",1193
"500","Lilian","F","637","549",1186
"607","Ariyah","F","478","707",1185
"482","Haylee","F","665","519",1184
"525","Hanna","F","596","583",1179
"534","Helena","F","581","598",1179
"548","Winter","F","565","614",1179
"531","Cameron","F","586","583",1169
"509","Alanna","F","618","549",1167
"511","Karla","F","612","551",1163
"557","Henley","F","558","602",1160
"519","Charley","F","603","555",1158
"526","Gloria","F","595","563",1158
"542","Sasha","F","576","581",1157
"623","Remington","F","461","696",1157
"510","Cassandra","F","612","540",1152
"496","Jayda","F","642","509",1151
"536","Imani","F","580","568",1148
"544","Cecelia","F","570","573",1143
"541","Johanna","F","576","560",1136
"486","Elsa","F","656","476",1132
"552","Liberty","F","560","571",1131
"576","Mabel","F","529","602",1131
"539","Janiyah","F","578","550",1128
"540","Cynthia","F","577","550",1127
"522","Rebekah","F","600","522",1122
"558","Skyla","F","557","561",1118
"564","Mariam","F","547","566",1113
"572","Alayah","F","537","576",1113
"635","Samara","F","448","663",1111
"513","Aileen","F","609","499",1108
"553","Maia","F","560","542",1102
"571","Maryam","F","540","562",1102
"566","Anne","F","541","560",1101
"554","Crystal","F","559","539",1098
"578","Lainey","F","527","571",1098
"569","Beatrice","F","540","553",1093
"587","Lilith","F","512","580",1092
"590","Meredith","F","509","583",1092
"532","Kailey","F","586","504",1090
"533","Bridget","F","581","506",1087
"586","Mira","F","515","567",1082
"538","Marissa","F","579","502",1081
"551","Bailee","F","560","518",1078
"562","Marie","F","551","526",1077
"603","Blair","F","483","594",1077
"751","Avianna","F","374","703",1077
"565","Hallie","F","542","533",1075
"543","Kaliyah","F","574","497",1071
"559","Monica","F","554","515",1069
"550","Anya","F","561","507",1068
"549","Julissa","F","563","502",1065
"634","Magnolia","F","448","609",1057
"555","Kaylie","F","559","496",1055
"600","Myra","F","493","560",1053
"547","Hayley","F","565","476",1041
"582","Azalea","F","520","520",1040
"636","Galilea","F","446","594",1040
"580","Anika","F","522","516",1038
"588","Mae","F","511","527",1038
"640","Kensley","F","445","591",1036
"602","Demi","F","484","548",1032
"593","Emelia","F","504","527",1031
"560","Dallas","F","551","479",1030
"597","Elianna","F","494","535",1029
"556","Charli","F","558","470",1028
"563","Braylee","F","549","478",1027
"570","Madalyn","F","540","487",1027
"577","Coraline","F","527","496",1023
"637","Renata","F","446","573",1019
"581","Dayana","F","521","496",1017
"579","Lillie","F","526","490",1016
"584","Addisyn","F","515","498",1013
"610","Everleigh","F","474","538",1012
"583","Jaliyah","F","516","492",1008
"573","Greta","F","533","471",1004
"625","Pearl","F","458","546",1004
"613","Oakley","F","471","531",1002
"617","Anahi","F","466","535",1001
"616","Ivanna","F","467","532",999
"546","Jessa","F","569","429",998
"568","Annika","F","540","454",994
"624","Maisie","F","458","536",994
"704","Wren","F","403","589",992
"521","Kaelyn","F","601","390",991
"594","Melina","F","502","489",991
"667","Tenley","F","426","565",991
"589","Angie","F","510","480",990
"601","Jaelyn","F","488","488",976
"567","Angelique","F","540","434",974
"574","Lilyana","F","532","440",972
"606","Shiloh","F","481","488",969
"604","Mikaela","F","483","485",968
"631","Kimber","F","450","514",964
"591","Guadalupe","F","505","457",962
"596","Alena","F","496","465",961
"605","Tiana","F","482","474",956
"614","Miah","F","469","474",943
"618","Emmy","F","466","476",942
"575","Kadence","F","531","410",941
"599","Jaelynn","F","493","442",935
"595","Aniya","F","498","429",927
"615","Jessie","F","468","456",924
"585","Emilee","F","515","407",922
"735","Jolene","F","382","540",922
"633","Elliot","F","448","473",921
"612","Alia","F","471","449",920
"641","Siena","F","445","475",920
"701","Sloan","F","405","514",919
"682","Leona","F","417","501",918
"649","Kori","F","441","473",914
"664","Alaia","F","427","486",913
"674","Elaine","F","422","490",912
"629","Rosa","F","452","459",911
"654","Lorelai","F","437","474",911
"628","Karsyn","F","452","453",905
"627","Emory","F","454","447",901
"692","Jemma","F","409","487",896
"630","Irene","F","451","444",895
"622","Kora","F","461","433",894
"672","Elliott","F","423","469",892
"626","Nathalie","F","455","434",889
"643","Adele","F","442","443",885
"639","Amelie","F","445","438",883
"681","Rory","F","418","465",883
"713","Saige","F","397","481",878
"663","Armani","F","429","447",876
"666","Milani","F","426","450",876
"619","Ansley","F","464","409",873
"729","Addilynn","F","386","486",872
"621","Annabel","F","461","406",867
"632","Lylah","F","450","414",864
"917","Aitana","F","299","564",863
"648","Zelda","F","442","420",862
"688","Chanel","F","413","449",862
"668","Teresa","F","426","435",861
"676","Kenna","F","421","439",860
"669","Linda","F","425","434",859
"659","Marina","F","434","424",858
"699","Clarissa","F","405","453",858
"686","Myah","F","414","442",856
"702","Collins","F","404","451",855
"655","Elyse","F","436","417",853
"673","Sutton","F","423","430",853
"719","Ivory","F","394","458",852
"747","Royal","F","376","474",850
"646","Perla","F","442","407",849
"706","Ellen","F","402","446",848
"680","Esme","F","418","426",844
"714","Dorothy","F","396","448",844
"675","Aliza","F","421","422",843
"677","Meadow","F","420","423",843
"689","Zahra","F","411","432",843
"707","Hadassah","F","402","440",842
"658","Avah","F","434","403",837
"611","Lindsey","F","473","363",836
"650","Jaycee","F","440","396",836
"642","Kiera","F","444","391",835
"711","Reyna","F","399","435",834
"693","Ariya","F","408","424",832
"703","Laylah","F","403","429",832
"825","Celine","F","339","492",831
"725","Malaya","F","390","440",830
"647","Tatiana","F","442","386",828
"653","Jayden","F","437","389",826
"762","Laurel","F","368","456",824
"671","Amirah","F","424","399",823
"722","Rayna","F","392","431",823
"715","Elisabeth","F","396","424",820
"638","Whitney","F","446","373",819
"828","Adley","F","337","482",819
"620","Kaylin","F","464","353",817
"804","Julieta","F","348","468",816
"678","Milana","F","419","395",814
"691","Karter","F","410","404",814
"670","Natasha","F","425","387",812
"716","Lilianna","F","396","415",811
"778","Kenia","F","361","450",811
"720","Monroe","F","394","416",810
"662","Dulce","F","430","379",809
"645","Laney","F","442","366",808
"718","Liv","F","395","413",808
"644","Bria","F","442","364",806
"976","Ophelia","F","276","529",805
"687","Alma","F","413","390",803
"739","Mara","F","380","423",803
"755","Jolie","F","372","430",802
"700","Lailah","F","405","396",801
"656","Kynlee","F","436","364",800
"1150","Royalty","F","219","581",800
"660","Kenley","F","431","368",799
"684","Joselyn","F","414","385",799
"738","Lea","F","380","419",799
"694","Eileen","F","408","389",797
"726","Alaya","F","389","405",794
"690","Audrina","F","410","383",793
"846","Harlee","F","331","462",793
"651","Montserrat","F","440","349",789
"724","Livia","F","390","399",789
"657","Kailyn","F","435","353",788
"758","Penny","F","372","416",788
"705","Amiya","F","402","384",786
"665","Breanna","F","427","358",785
"698","Milan","F","406","376",782
"709","Jaylene","F","400","382",782
"798","Aurelia","F","351","431",782
"710","Lexie","F","399","381",780
"727","Clare","F","388","392",780
"730","Amani","F","385","395",780
"757","Milena","F","372","405",777
"741","Chaya","F","378","397",775
"697","Karlee","F","406","367",773
"740","Lennox","F","379","394",773
"805","Keyla","F","348","425",773
"679","Alyson","F","418","354",772
"779","Scarlette","F","361","411",772
"745","Zariyah","F","377","394",771
"728","Erika","F","388","381",769
"685","Madalynn","F","414","354",768
"683","Erica","F","416","346",762
"847","Kalani","F","331","431",762
"862","Jayde","F","322","440",762
"781","Leyla","F","360","399",759
"749","Kinslee","F","375","383",758
"765","Noa","F","368","389",757
"782","Wynter","F","360","397",757
"736","Aliana","F","381","375",756
"774","Rosie","F","364","391",755
"712","Averi","F","398","356",754
"721","Aryanna","F","393","361",754
"771","Ariadne","F","366","387",753
"742","Claudia","F","378","371",749
"764","Mina","F","368","380",748
"746","Gwen","F","376","371",747
"789","Martha","F","356","389",745
"790","Christine","F","355","388",743
"791","Emerie","F","355","386",741
"775","Aubrielle","F","362","378",740
"732","Corinne","F","385","354",739
"695","Kallie","F","407","331",738
"598","Caitlyn","F","493","244",737
"811","Hadlee","F","345","392",737
"696","Emmalynn","F","406","330",736
"801","Salma","F","351","385",736
"731","Cara","F","385","350",735
"787","Amaris","F","356","376",732
"777","Arely","F","361","369",730
"770","Sky","F","367","362",729
"737","Anabelle","F","380","348",728
"748","Jaylee","F","375","353",728
"808","Patricia","F","347","380",727
"843","Remy","F","332","394",726
"734","Roselyn","F","383","342",725
"756","Kassandra","F","372","353",725
"752","Carolyn","F","373","349",722
"763","Leanna","F","368","354",722
"776","Noemi","F","362","360",722
"708","Danica","F","401","320",721
"816","Clementine","F","342","378",720
"733","Paola","F","383","336",719
"817","Lara","F","342","377",719
"753","Courtney","F","373","344",717
"841","Joyce","F","332","385",717
"754","Lisa","F","373","342",715
"766","Nola","F","368","347",715
"767","Isabela","F","367","346",713
"768","Jazlynn","F","367","346",713
"823","Simone","F","340","373",713
"723","Jaylynn","F","390","322",712
"773","Kairi","F","365","347",712
"821","Khaleesi","F","341","370",711
"784","Amia","F","358","351",709
"835","Maleah","F","335","374",709
"717","Janessa","F","395","312",707
"750","Raquel","F","375","332",707
"812","Giovanna","F","344","363",707
"792","Taliyah","F","355","350",705
"786","Katalina","F","357","347",704
"794","Thalia","F","354","350",704
"810","Emmeline","F","346","358",704
"814","Ayleen","F","342","361",703
"818","Tori","F","342","361",703
"861","Analia","F","322","381",703
"795","Estrella","F","353","349",702
"824","Amalia","F","339","357",696
"807","Deborah","F","347","348",695
"848","Chana","F","330","364",694
"609","Caitlin","F","475","217",692
"743","Kristina","F","378","313",691
"788","Hunter","F","356","335",691
"876","Kailani","F","316","374",690
"759","Alannah","F","370","318",688
"837","Aiyana","F","333","355",688
"785","Naya","F","358","329",687
"802","Brenda","F","349","338",687
"852","Azariah","F","326","361",687
"877","Rylan","F","316","371",687
"760","Ciara","F","370","316",686
"838","Briar","F","333","353",686
"744","Kaylynn","F","377","308",685
"652","Katelynn","F","439","245",684
"761","Zoie","F","370","311",681
"879","Paulina","F","314","367",681
"819","Estelle","F","341","339",680
"772","Carlee","F","366","313",679
"769","Monserrat","F","367","308",675
"829","Kathleen","F","337","338",675
"844","Ryann","F","332","343",675
"884","Astrid","F","311","363",674
"856","Frida","F","325","348",673
"796","Lillianna","F","353","316",669
"923","Belen","F","296","373",669
"815","Casey","F","342","325",667
"850","Adrienne","F","327","340",667
"820","Karlie","F","341","325",666
"873","Zaria","F","318","348",666
"855","Celia","F","325","339",664
"857","Marianna","F","325","339",664
"883","Yareli","F","312","351",663
"854","Hana","F","326","334",660
"851","Lina","F","327","332",659
"827","Zaniyah","F","338","320",658
"793","Brenna","F","354","302",656
"888","Paula","F","310","346",656
"904","Nataly","F","303","353",656
"831","Sandra","F","337","318",655
"955","Elora","F","283","372",655
"830","Paityn","F","337","317",654
"797","Zendaya","F","352","300",652
"860","Rivka","F","324","325",649
"840","Holland","F","332","316",648
"822","Nancy","F","341","306",647
"865","Barbara","F","321","326",647
"907","Louisa","F","302","345",647
"946","Nala","F","286","361",647
"799","Marjorie","F","351","295",646
"853","Dana","F","326","320",646
"813","Kailee","F","344","301",645
"869","Romina","F","321","321",642
"874","Carla","F","317","322",639
"780","Farrah","F","360","278",638
"800","Milania","F","351","287",638
"870","Evalyn","F","320","318",638
"1030","Poppy","F","259","379",638
"929","Faye","F","292","345",637
"999","Princess","F","268","369",637
"926","Raina","F","295","341",636
"867","Emilie","F","321","314",635
"880","Sariah","F","313","322",635
"973","Tinley","F","278","357",635
"871","Bryleigh","F","319","314",633
"891","Kenya","F","309","324",633
"905","Iliana","F","302","331",633
"834","Lizbeth","F","335","296",631
"845","Caylee","F","331","300",631
"1019","Antonella","F","261","370",631
"866","Bonnie","F","321","309",630
"893","Aya","F","308","322",630
"885","Avalynn","F","311","318",629
"809","Desiree","F","346","282",628
"842","Nathaly","F","332","295",627
"863","Nathalia","F","322","305",627
"833","Hailee","F","335","289",624
"890","Kai","F","309","315",624
"920","Landry","F","297","327",624
"839","Marisol","F","333","290",623
"909","Dalary","F","301","322",623
"1009","Mavis","F","265","358",623
"1056","Kaylani","F","249","374",623
"965","Heavenly","F","280","342",622
"914","Andi","F","300","321",621
"931","Aliya","F","290","331",621
"990","Zaylee","F","272","349",621
"858","Yamileth","F","325","295",620
"1013","Mercy","F","263","357",620
"806","Adilynn","F","347","271",618
"875","Estella","F","316","302",618
"895","Annalee","F","307","311",618
"803","Shayla","F","349","268",617
"941","Wendy","F","288","328",616
"983","Stevie","F","273","343",616
"826","Madyson","F","339","276",615
"963","Ellis","F","281","334",615
"903","Emmaline","F","303","309",612
"954","Reina","F","284","328",612
"836","Micah","F","334","276",610
"864","Anabella","F","321","287",608
"921","Maliah","F","297","310",607
"934","Veda","F","289","318",607
"886","Jewel","F","311","295",606
"894","Julianne","F","308","298",606
"927","Judith","F","293","313",606
"859","Kaya","F","324","280",604
"968","Kiana","F","279","325",604
"1075","Joelle","F","243","361",604
"783","Bryanna","F","359","244",603
"882","Kaiya","F","312","290",602
"896","Zion","F","307","295",602
"959","Ingrid","F","282","320",602
"952","Hadleigh","F","284","317",601
"868","Joslyn","F","321","279",600
"899","Marleigh","F","305","295",600
"832","Aryana","F","335","264",599
"881","Giana","F","312","287",599
"1125","Itzayana","F","226","367",593
"933","Aranza","F","289","303",592
"887","Jasmin","F","310","281",591
"900","Paloma","F","304","287",591
"948","Tegan","F","286","305",591
"981","Abril","F","274","316",590
"872","Ally","F","318","271",589
"902","Amya","F","303","286",589
"928","Susan","F","293","296",589
"944","Zainab","F","287","300",587
"925","Vienna","F","296","290",586
"849","Lindsay","F","328","257",585
"971","Aubriella","F","278","305",583
"950","Ellison","F","285","297",582
"932","Yasmin","F","290","291",581
"988","Noor","F","272","306",578
"910","Halle","F","301","276",577
"1110","Reign","F","232","344",576
"915","Arden","F","300","275",575
"947","Tabitha","F","286","289",575
"897","Ann","F","306","264",570
"980","Sharon","F","275","295",570
"979","Mariyah","F","275","294",569
"989","Sariyah","F","272","297",569
"978","Lyra","F","275","292",567
"878","Kayden","F","314","252",566
"922","Alisha","F","296","269",565
"918","Briley","F","297","267",564
"1008","Jana","F","265","299",564
"912","Tara","F","301","262",563
"919","Elin","F","297","266",563
"970","Miya","F","279","284",563
"901","Aminah","F","303","258",561
"913","Alisson","F","300","261",561
"937","Cherish","F","288","273",561
"892","Kristen","F","309","251",560
"924","Esperanza","F","296","264",560
"916","Aimee","F","299","259",558
"936","Azaria","F","288","270",558
"975","Moriah","F","277","281",558
"1175","Alessia","F","214","344",558
"962","Aislinn","F","281","276",557
"992","Rhea","F","271","285",556
"956","Harmoni","F","283","271",554
"1044","Ellianna","F","253","301",554
"889","Jordynn","F","309","244",553
"991","Frankie","F","271","282",553
"1032","Alyvia","F","258","295",553
"964","Heather","F","281","271",552
"1080","Louise","F","242","309",551
"1004","Aadhya","F","265","284",549
"1026","Rayne","F","260","289",549
"961","Lilia","F","282","266",548
"1068","Emmie","F","245","303",548
"1081","Vada","F","242","306",548
"953","Meilani","F","284","263",547
"957","Luz","F","283","263",546
"1010","Tinsley","F","265","279",544
"906","Jaida","F","302","241",543
"969","Lilyanna","F","279","264",543
"949","Cordelia","F","285","257",542
"942","Dixie","F","287","254",541
"1051","Belle","F","249","291",540
"972","Kensington","F","278","261",539
"1005","Ari","F","265","274",539
"1006","Aubri","F","265","274",539
"958","America","F","282","256",538
"1108","Maxine","F","233","305",538
"940","Kyndall","F","288","247",535
"1054","Harleigh","F","249","285",534
"982","Avalyn","F","273","260",533
"987","Mollie","F","272","261",533
"911","Sarahi","F","301","231",532
"938","Jaylin","F","288","244",532
"974","Emmalee","F","277","255",532
"908","Asia","F","301","229",530
"1001","Alianna","F","267","263",530
"960","Kimora","F","282","247",529
"1038","Ayana","F","256","273",529
"1037","Anniston","F","256","272",528
"1076","Ramona","F","243","285",528
"1000","Sidney","F","268","258",526
"1020","Antonia","F","261","264",525
"930","Saniyah","F","291","233",524
"951","Angeline","F","284","240",524
"1018","India","F","262","262",524
"1003","Mattie","F","267","255",522
"1048","Amayah","F","250","271",521
"1024","Abrielle","F","260","260",520
"1025","Akira","F","260","260",520
"1113","Maren","F","230","290",520
"998","Libby","F","269","250",519
"898","Kiley","F","305","212",517
"966","Natalee","F","280","236",516
"1022","Raylee","F","261","253",514
"967","Jenny","F","279","234",513
"995","Aubrianna","F","269","244",513
"1034","Alisa","F","257","256",513
"1040","Amora","F","255","258",513
"1052","Chandler","F","249","264",513
"1039","Addalyn","F","255","256",511
"1014","Miley","F","263","247",510
"939","Kaelynn","F","288","221",509
"945","Alissa","F","286","223",509
"1002","Janae","F","267","242",509
"1146","Calliope","F","220","289",509
"1047","Samiyah","F","252","254",506
"1205","Ailani","F","206","300",506
"996","Janiya","F","269","236",505
"1053","Cindy","F","249","256",505
"1077","Treasure","F","243","262",505
"984","Taya","F","273","231",504
"1070","Sonia","F","245","259",504
"1135","Rosalyn","F","223","281",504
"1155","Novalee","F","218","286",504
"1062","Audriana","F","247","255",502
"1170","Blaire","F","215","287",502
"1109","Maylee","F","233","268",501
"1033","Dalia","F","258","242",500
"1042","Carlie","F","254","246",500
"1118","Riya","F","228","272",500
"977","Charlize","F","275","224",499
"1035","Diya","F","257","242",499
"1029","Dani","F","259","239",498
"1079","Etta","F","242","256",498
"1027","Robin","F","260","237",497
"1086","Everlee","F","240","257",497
"1090","Renee","F","240","257",497
"1046","Robyn","F","252","244",496
"1181","Sylvie","F","214","282",496
"985","Giavanna","F","272","223",495
"986","Ireland","F","272","223",495
"935","Yaritza","F","289","205",494
"1060","Elina","F","248","246",494
"1057","Maddie","F","249","243",492
"1101","Magdalena","F","234","258",492
"1015","Cambria","F","262","229",491
"1064","Carina","F","246","244",490
"1088","Mercedes","F","240","250",490
"1007","Danika","F","265","224",489
"1017","Diamond","F","262","226",488
"1171","Davina","F","215","273",488
"1111","Opal","F","231","256",487
"997","Jocelynn","F","269","217",486
"1072","Ayanna","F","244","242",486
"1016","Devyn","F","262","223",485
"1116","Jurnee","F","229","256",485
"1049","Temperance","F","250","232",482
"1091","Spencer","F","238","244",482
"1031","Abbigail","F","258","223",481
"1028","Ayva","F","259","221",480
"1036","Anais","F","256","224",480
"1093","Sailor","F","237","242",479
"1021","Mckayla","F","261","217",478
"1143","Marlowe","F","221","256",477
"1148","Xiomara","F","220","257",477
"1220","Bexley","F","202","275",477
"1045","Mylah","F","253","223",476
"1063","Evalynn","F","247","229",476
"1067","Tamia","F","246","230",476
"1103","Rilynn","F","234","242",476
"993","Denise","F","270","205",475
"1011","Aliah","F","264","210",474
"1023","Regan","F","261","213",474
"1050","Alaysia","F","249","225",474
"1119","Rosalee","F","228","245",473
"943","Neriah","F","287","185",472
"1105","Cristina","F","233","239",472
"1121","Kylah","F","227","245",472
"1139","Whitley","F","222","250",472
"1074","Austyn","F","243","227",470
"1097","Karleigh","F","235","235",470
"1078","Berkley","F","242","227",469
"1117","Keily","F","228","240",468
"1124","Fallon","F","226","241",467
"1059","Taryn","F","249","217",466
"1071","August","F","244","222",466
"1099","Scout","F","235","230",465
"1134","Micaela","F","223","242",465
"1147","Violeta","F","220","245",465
"1130","Samira","F","225","238",463
"1172","Della","F","215","247",462
"1084","Vivien","F","241","219",460
"1178","Florence","F","214","246",460
"1164","Elodie","F","216","243",459
"1280","Nalani","F","189","269",458
"1012","Kaidence","F","264","193",457
"1066","Macey","F","246","211",457
"1069","Promise","F","245","212",457
"1136","Jenesis","F","222","234",456
"1162","Loretta","F","217","239",456
"1065","Londynn","F","246","209",455
"1061","Araceli","F","247","207",454
"1085","Aanya","F","240","214",454
"1227","Egypt","F","200","254",454
"1089","Pyper","F","240","213",453
"1098","Neveah","F","235","218",453
"1115","Jubilee","F","229","223",452
"1073","Bayleigh","F","244","206",450
"1129","Natalya","F","225","225",450
"1041","Ellery","F","255","193",448
"1131","Campbell","F","224","224",448
"1138","Sherlyn","F","222","226",448
"1141","Kelsie","F","221","227",448
"1196","Malayah","F","209","239",448
"1082","Paisleigh","F","241","206",447
"1177","Dalilah","F","214","232",446
"1211","Valery","F","205","241",446
"1106","Honesty","F","233","212",445
"1190","Winnie","F","212","233",445
"1275","Kamiyah","F","190","255",445
"1083","Patience","F","241","203",444
"1120","Tess","F","228","216",444
"1128","Makena","F","225","219",444
"1127","Krystal","F","225","218",443
"1058","Shannon","F","249","193",442
"1092","Kasey","F","237","205",442
"1126","Adalee","F","225","217",442
"1276","Margo","F","190","252",442
"1087","Meghan","F","240","201",441
"1157","Adilyn","F","217","224",441
"1104","Saanvi","F","234","206",440
"1137","Selina","F","222","218",440
"994","Kaitlynn","F","270","169",439
"1095","Carleigh","F","236","203",439
"1160","Kamilah","F","217","222",439
"1102","Marian","F","234","202",436
"1140","Adilene","F","221","215",436
"1165","Gracyn","F","216","220",436
"1213","Leela","F","204","231",435
"1217","Raya","F","203","232",435
"1151","Addalynn","F","218","216",434
"1206","Alora","F","206","227",433
"1132","Luisa","F","224","208",432
"1144","Sally","F","221","210",431
"1096","Gwyneth","F","236","194",430
"1142","Maisy","F","221","209",430
"1448","Saoirse","F","159","271",430
"1055","Kaleigh","F","249","180",429
"1263","Aiyanna","F","192","237",429
"1361","Octavia","F","174","255",429
"1123","Adela","F","226","202",428
"1186","Drew","F","212","216",428
"1156","Sunny","F","218","209",427
"1112","Lesly","F","230","194",424
"1153","Kataleya","F","218","206",424
"1169","Baylor","F","215","209",424
"1158","Brynleigh","F","217","206",423
"1183","Beatrix","F","213","209",422
"1282","Shea","F","189","233",422
"1225","Elayna","F","201","219",420
"1094","Ailyn","F","236","183",419
"1273","Agnes","F","190","229",419
"1207","Amiah","F","206","212",418
"1192","Theresa","F","210","207",417
"1258","Karis","F","194","223",417
"1345","Palmer","F","176","241",417
"1179","Karma","F","214","202",416
"1180","Selene","F","214","202",416
"1299","Bellamy","F","184","231",415
"1167","Marlene","F","216","198",414
"1187","Kamille","F","212","202",414
"1235","Sanaa","F","199","215",414
"1256","Emerald","F","194","219",413
"1417","Legacy","F","163","250",413
"1145","Bree","F","220","192",412
"1209","Kinzley","F","205","207",412
"1218","Seraphina","F","203","209",412
"1247","Maryjane","F","196","216",412
"1161","Katerina","F","217","194",411
"1189","Milah","F","212","198",410
"1202","Noel","F","208","202",410
"1283","Viola","F","189","221",410
"1184","Ila","F","213","196",409
"1210","Stacy","F","205","204",409
"1043","Charleston","F","254","154",408
"1154","Katrina","F","218","190",408
"1176","Cecily","F","214","194",408
"1252","Raylynn","F","195","213",408
"1122","Addie","F","226","181",407
"1174","Addelyn","F","214","193",407
"1226","Preslee","F","201","206",407
"1193","Annelise","F","209","197",406
"1133","Kailynn","F","223","182",405
"1173","Kaleah","F","215","190",405
"1197","Ezra","F","208","197",405
"1381","Shanaya","F","171","234",405
"1200","Lillyana","F","208","196",404
"1257","Jovie","F","194","210",404
"1168","Audrianna","F","215","188",403
"1246","Malani","F","196","207",403
"1100","Carley","F","234","168",402
"1208","Charity","F","206","196",402
"1267","Cassie","F","192","210",402
"1191","Emani","F","211","190",401
"1224","Coral","F","201","199",400
"1296","Karmen","F","185","215",400
"1219","Violette","F","203","196",399
"1281","Rita","F","189","209",398
"1317","Malka","F","180","218",398
"1215","Geneva","F","203","194",397
"1230","Soraya","F","200","197",397
"1242","Nellie","F","197","200",397
"1243","Vivianna","F","197","200",397
"1152","Aleigha","F","218","178",396
"1310","Roslyn","F","181","215",396
"1163","Bryn","F","216","178",394
"1166","Larissa","F","216","178",394
"1194","Deanna","F","209","185",394
"1212","Brynley","F","204","190",394
"1228","Elia","F","200","194",394
"1261","Kaycee","F","193","201",394
"1359","Celina","F","174","220",394
"1107","Kourtney","F","233","160",393
"1188","Lillyanna","F","212","181",393
"1231","Ashtyn","F","199","194",393
"1251","Nahla","F","195","198",393
"1320","Rebeca","F","179","214",393
"1221","Tyler","F","202","190",392
"1297","Rylynn","F","185","207",392
"1302","Ivana","F","183","208",391
"1369","Zoya","F","173","218",391
"1239","Anayah","F","197","193",390
"1268","Lorena","F","192","198",390
"1185","Abbie","F","212","176",388
"1204","Marlie","F","207","180",387
"1434","Litzy","F","161","226",387
"1159","Izabelle","F","217","169",386
"1237","Dania","F","198","188",386
"1253","Susanna","F","195","191",386
"1269","Ashton","F","191","195",386
"1214","Lianna","F","204","180",384
"1244","Leena","F","196","188",384
"1254","Aliyana","F","194","189",383
"1291","Meera","F","186","197",383
"1234","Mika","F","199","183",382
"1271","Christiana","F","191","191",382
"1371","Jakayla","F","172","210",382
"1660","Arlette","F","128","254",382
"1216","Giada","F","203","178",381
"1344","Luella","F","176","205",381
"1182","Tia","F","214","166",380
"1233","Kaley","F","199","181",380
"1222","Annabeth","F","201","178",379
"1397","Carsyn","F","167","212",379
"1149","Aubriana","F","219","159",378
"1240","Delia","F","197","181",378
"1298","Aida","F","184","194",378
"1241","Denver","F","197","180",377
"1352","Evelina","F","175","202",377
"1236","Yara","F","199","177",376
"1114","Taraji","F","230","145",375
"1255","Eisley","F","194","181",375
"1337","Annette","F","176","199",375
"1265","Belinda","F","192","182",374
"1301","Blessing","F","184","190",374
"1464","Eleanora","F","156","218",374
"1232","Destinee","F","199","174",373
"1329","Kyrie","F","178","195",373
"1229","Haleigh","F","200","172",372
"1245","Leilah","F","196","176",372
"1789","Arleth","F","116","256",372
"1469","Rowyn","F","156","215",371
"1326","Annaliese","F","178","192",370
"1346","Persephone","F","176","194",370
"1195","Kaylen","F","209","160",369
"1294","Gisselle","F","185","184",369
"1313","Aarya","F","180","189",369
"1266","Brisa","F","192","176",368
"1340","Flora","F","176","192",368
"3359","Kehlani","F","48","320",368
"1201","Maritza","F","208","159",367
"1270","Betty","F","191","176",367
"1279","Mayra","F","189","178",367
"1348","Saniya","F","176","191",367
"1264","Audra","F","192","174",366
"1303","Kinleigh","F","183","183",366
"1386","Marcella","F","170","195",365
"1198","Jacquelyn","F","208","156",364
"1203","Kinlee","F","207","157",364
"1250","Miyah","F","195","169",364
"1277","Tianna","F","190","174",364
"1286","Skylynn","F","188","176",364
"1322","Roxanne","F","179","185",364
"1325","Annaleigh","F","178","186",364
"1356","Leilany","F","175","189",364
"1460","Oaklee","F","157","207",364
"1223","Caydence","F","201","162",363
"1312","Yesenia","F","181","182",363
"1314","Asha","F","180","183",363
"1374","Sofie","F","172","191",363
"1238","Janice","F","198","164",362
"1327","Carson","F","178","184",362
"1351","Colbie","F","175","187",362
"1418","Yuliana","F","163","199",362
"1445","Kya","F","159","203",362
"1335","Rubi","F","177","183",360
"1293","Alex","F","185","173",358
"1199","Kalia","F","208","149",357
"1357","Vayda","F","175","182",357
"1366","Finnley","F","173","184",357
"1259","Karissa","F","194","162",356
"1354","Jazmyn","F","175","181",356
"1388","Zayla","F","170","186",356
"1306","Harriet","F","181","174",355
"1318","Kacey","F","179","176",355
"1330","Rihanna","F","178","177",355
"1272","Kaylyn","F","191","163",354
"1309","Malak","F","181","173",354
"1321","Reece","F","179","175",354
"1333","Khadija","F","177","177",354
"1433","Journi","F","161","193",354
"1319","Lilyann","F","179","174",353
"1398","Darcy","F","167","186",353
"1315","Clover","F","180","172",352
"1342","Karly","F","176","176",352
"1530","Indie","F","146","206",352
"1338","Brinlee","F","176","175",351
"1391","Keila","F","169","182",351
"1421","Amaia","F","162","189",351
"1443","Ida","F","159","192",351
"1375","Calista","F","171","179",350
"1383","Yazmin","F","171","179",350
"1311","Shirley","F","181","168",349
"1382","Skylah","F","171","178",349
"1466","Kamari","F","156","193",349
"1274","Britney","F","190","158",348
"1405","Pamela","F","166","182",348
"1248","Anneliese","F","195","152",347
"1287","Nyomi","F","187","160",347
"1316","Maite","F","180","167",347
"1431","Salem","F","162","184",346
"1304","Rachael","F","183","162",345
"1519","Queen","F","148","197",345
"1732","Waverly","F","121","224",345
"1295","Isabell","F","185","159",344
"1289","Haylie","F","186","157",343
"1364","Araya","F","173","170",343
"1367","Kinsey","F","173","170",343
"1355","Katarina","F","175","167",342
"1373","Shay","F","172","170",342
"1362","Ananya","F","173","167",340
"1400","Emi","F","167","173",340
"1284","Ali","F","188","151",339
"1358","Brayleigh","F","174","165",339
"1379","Jacey","F","171","168",339
"1393","Silvia","F","169","169",338
"1308","Kendyl","F","181","156",337
"1360","Emiliana","F","174","163",337
"1496","Mireya","F","153","184",337
"1260","Caleigh","F","193","143",336
"1390","Jazelle","F","169","167",336
"1414","Yaretzy","F","164","172",336
"1429","Mariella","F","162","174",336
"1292","Milagros","F","186","149",335
"1332","Kayleen","F","177","158",335
"1336","Toni","F","177","158",335
"1377","Grecia","F","171","164",335
"1380","Priya","F","171","164",335
"1409","Elinor","F","165","170",335
"1416","Keziah","F","163","172",335
"1430","Nadine","F","162","173",335
"1262","Kendal","F","193","141",334
"1290","Karli","F","186","148",334
"1278","Laniyah","F","189","144",333
"1300","Bentley","F","184","149",333
"1353","Jaleah","F","175","158",333
"1399","Elissa","F","167","166",333
"1446","Layan","F","159","174",333
"1334","Linnea","F","177","155",332
"1347","Petra","F","176","156",332
"1495","Kynslee","F","153","179",332
"1288","Vida","F","187","144",331
"1365","Audree","F","173","158",331
"1402","Andie","F","166","165",331
"1425","Gretchen","F","162","169",331
"1435","Dariana","F","160","171",331
"1547","Lucinda","F","143","187",330
"1305","Irie","F","182","147",329
"1324","Tamara","F","179","150",329
"1370","Farah","F","172","156",328
"1502","Ayesha","F","151","177",328
"1385","Janie","F","170","157",327
"1406","Tesla","F","166","161",327
"1419","Zahara","F","163","164",327
"1389","Grayson","F","169","157",326
"1472","Evangelina","F","155","170",325
"1339","Emalyn","F","176","148",324
"1395","Jazzlyn","F","168","155",323
"1423","Cheyanne","F","162","160",322
"1486","Raleigh","F","154","168",322
"1285","Nya","F","188","133",321
"1412","Jaylyn","F","164","157",321
"1453","Lincoln","F","158","163",321
"1531","Kamiya","F","146","175",321
"1394","Areli","F","168","152",320
"1462","Yasmine","F","157","163",320
"1473","Marin","F","155","165",320
"1497","Blythe","F","152","168",320
"1420","Alanah","F","162","157",319
"1571","Freyja","F","139","180",319
"1249","Estefania","F","195","123",318
"1404","Kenleigh","F","166","152",318
"1437","Aadya","F","159","159",318
"1492","Beverly","F","153","165",318
"1522","Anita","F","147","171",318
"1323","Samiya","F","179","138",317
"1436","Dior","F","160","157",317
"1451","Dina","F","158","159",317
"1463","Ashanti","F","156","161",317
"1478","Elly","F","154","163",317
"1341","Guinevere","F","176","140",316
"1447","Nailah","F","159","157",316
"1480","Janet","F","154","162",316
"1343","Kyndal","F","176","139",315
"1384","Arlene","F","170","145",315
"1408","Delanie","F","165","150",315
"1487","Sanai","F","154","161",315
"1499","Kenzi","F","152","163",315
"1516","Ayah","F","148","167",315
"1407","Dayanna","F","165","149",314
"1424","Damaris","F","162","152",314
"1428","Maribel","F","162","152",314
"1468","Rayleigh","F","156","158",314
"1657","Zola","F","129","185",314
"1392","Nyah","F","169","144",313
"1454","Lucie","F","158","155",313
"1465","Jamiyah","F","156","156",312
"1526","Sapphire","F","147","165",312
"1763","Emberly","F","118","194",312
"1328","Karley","F","178","133",311
"1512","Kalea","F","149","162",311
"1545","Keilani","F","143","168",311
"1372","Melinda","F","172","138",310
"1426","Haddie","F","162","148",310
"1525","Quincy","F","147","163",310
"1556","Prisha","F","141","169",310
"1455","Nayla","F","158","151",309
"1470","Zella","F","156","153",309
"1551","Imogen","F","141","168",309
"1669","Darla","F","127","182",309
"1396","Shreya","F","168","140",308
"1457","Tallulah","F","158","150",308
"1584","Hillary","F","137","171",308
"1633","Rowen","F","131","177",308
"1378","Isadora","F","171","136",307
"1410","Anabel","F","164","143",307
"1450","Ariela","F","158","149",307
"1488","Tania","F","154","153",307
"1513","Marion","F","149","158",307
"1524","Jaylen","F","147","160",307
"1533","Rosalind","F","146","161",307
"1661","Halo","F","128","179",307
"1376","Capri","F","171","135",306
"1452","Jaclyn","F","158","148",306
"1474","Naima","F","155","151",306
"1476","Analise","F","154","152",306
"1507","Harlie","F","150","156",306
"1307","Hayleigh","F","181","124",305
"1449","Winifred","F","159","146",305
"1471","Ema","F","155","150",305
"1444","Judy","F","159","145",304
"1483","Lidia","F","154","150",304
"1501","Avalon","F","151","153",304
"1573","Kaci","F","139","165",304
"1631","Lenora","F","131","173",304
"1368","Mayah","F","173","130",303
"1527","Carli","F","146","157",303
"1349","Sarina","F","176","126",302
"1415","Abbey","F","163","139",302
"1439","Darlene","F","159","143",302
"1482","Leticia","F","154","148",302
"1485","Nariah","F","154","148",302
"1561","Calla","F","140","162",302
"1578","Zora","F","139","163",302
"1601","Nori","F","134","168",302
"1607","Laken","F","133","169",302
"1493","Carmella","F","153","148",301
"1563","Kaila","F","140","161",301
"1505","Yoselin","F","151","149",300
"1635","Zadie","F","131","169",300
"1636","Alessa","F","130","170",300
"1659","Ariadna","F","128","172",300
"1477","Bernadette","F","154","145",299
"1427","Leigha","F","162","136",298
"1598","Chevelle","F","134","164",298
"1413","Sonya","F","164","133",297
"1481","Kynleigh","F","154","143",297
"1484","Maura","F","154","143",297
"1591","Noelia","F","136","161",297
"1403","Izzabella","F","166","130",296
"1503","Jael","F","151","145",296
"1575","Lizeth","F","139","157",296
"1599","Eleni","F","134","162",296
"1387","Shaylee","F","170","125",295
"1521","Aarna","F","147","148",295
"1523","Elana","F","147","148",295
"1536","Eunice","F","145","150",295
"1544","Kamilla","F","143","152",295
"1504","Lakyn","F","151","143",294
"1532","Lela","F","146","148",294
"1540","Constance","F","144","150",294
"1579","Camden","F","138","156",294
"1490","Aniston","F","153","140",293
"1506","Adalie","F","150","143",293
"1559","Aila","F","140","153",293
"1459","Essence","F","157","135",292
"1572","Gisele","F","139","153",292
"1411","Carissa","F","164","126",290
"1588","Dominique","F","136","154",290
"1350","Cailyn","F","175","114",289
"1529","Gwenyth","F","146","143",289
"1515","Vivianne","F","149","139",288
"1494","Kenlee","F","153","133",286
"1662","Letty","F","128","158",286
"1514","Pepper","F","149","136",285
"1549","Iyanna","F","142","143",285
"1680","Kathy","F","126","159",285
"2068","Rae","F","95","190",285
"1442","Hailie","F","159","125",284
"1518","Emeri","F","148","136",284
"1528","Charlene","F","146","138",284
"1539","Ayvah","F","144","140",284
"1543","Estefany","F","143","141",284
"1569","Amilia","F","139","145",284
"1626","Adalina","F","131","153",284
"1684","Amethyst","F","125","159",284
"1441","Emme","F","159","124",283
"1542","Arianny","F","143","140",283
"1899","Reya","F","107","176",283
"1479","Emmerson","F","154","128",282
"1664","Renesmee","F","128","154",282
"1756","Siya","F","119","163",282
"1508","Suri","F","150","131",281
"1541","Malina","F","144","137",281
"1673","Nicolette","F","127","154",281
"1557","Rosalina","F","141","139",280
"1564","Peighton","F","140","140",280
"1585","Kinsleigh","F","137","143",280
"1401","Kiersten","F","167","112",279
"1458","Alba","F","157","122",279
"1500","Aracely","F","151","128",279
"1605","Akshara","F","133","146",279
"1810","Hensley","F","115","164",279
"1981","Aveline","F","100","179",279
"1461","Tina","F","157","121",278
"1509","Yaneli","F","150","128",278
"1548","Symphony","F","143","135",278
"1614","Zaynab","F","133","145",278
"2407","Harlyn","F","76","202",278
"2817","Lyanna","F","62","216",278
"1537","Jersey","F","145","132",277
"1555","Mariela","F","141","136",277
"1608","Lillyann","F","133","144",277
"1617","Aspyn","F","132","145",277
"1643","Martina","F","130","147",277
"1363","Arantza","F","173","103",276
"1432","Annabell","F","161","115",276
"1440","Donna","F","159","117",276
"1663","Marceline","F","128","148",276
"1422","Azul","F","162","113",275
"1438","Aislynn","F","159","116",275
"1628","Jaslyn","F","131","144",275
"1770","Margaux","F","118","157",275
"1535","Bridgette","F","145","129",274
"1550","Katy","F","142","132",274
"1552","Jailyn","F","141","133",274
"1597","Avani","F","134","140",274
"1609","Lori","F","133","141",274
"1467","Lacy","F","156","117",273
"1554","Kamora","F","141","132",273
"1621","Hartley","F","132","141",273
"1648","Zia","F","130","142",272
"1814","Marielle","F","115","157",272
"1511","Anjali","F","149","122",271
"1517","Denisse","F","148","123",271
"1577","Rosalia","F","139","132",271
"1582","Cambree","F","137","134",271
"1592","Adina","F","135","136",271
"1724","Kaisley","F","121","150",271
"1932","Coralie","F","104","167",271
"1456","Shyla","F","158","112",270
"1589","Harmonie","F","136","134",270
"1624","Tahlia","F","132","138",270
"1742","Kirsten","F","120","150",270
"2146","Zaya","F","89","181",270
"1491","Austin","F","153","116",269
"1619","Dalila","F","132","137",269
"1792","Cielo","F","116","153",269
"1586","Noah","F","137","131",268
"1620","Everley","F","132","136",268
"1641","Geraldine","F","130","138",268
"1803","Navy","F","116","152",268
"1562","Jaqueline","F","140","127",267
"1567","Ziva","F","140","127",267
"1612","Ruthie","F","133","134",267
"1670","Journie","F","127","140",267
"1475","Stephany","F","155","111",266
"1498","Chasity","F","152","114",266
"1568","Abriella","F","139","127",266
"1583","Claira","F","137","129",266
"1593","Emry","F","135","131",266
"1743","Melani","F","120","146",266
"1681","Miabella","F","126","139",265
"1688","Carrie","F","125","140",265
"1719","Lorraine","F","122","143",265
"1667","Amariah","F","127","137",264
"1764","Emmarie","F","118","146",264
"1700","Anyla","F","124","139",263
"1733","Yuna","F","121","142",263
"1757","Teegan","F","119","144",263
"1638","Annistyn","F","130","132",262
"1653","Georgina","F","129","133",262
"1708","Cambrie","F","123","139",262
"1644","May","F","130","131",261
"1682","Montana","F","126","135",261
"1869","Zaina","F","110","151",261
"1762","Cleo","F","118","142",260
"1809","Edie","F","115","145",260
"1510","Abbygail","F","149","110",259
"1520","Yvette","F","148","111",259
"1534","Amyra","F","145","114",259
"1574","Lacie","F","139","120",259
"1600","Heidy","F","134","125",259
"1696","Margarita","F","125","134",259
"1753","Rhiannon","F","119","140",259
"1558","Taliah","F","141","117",258
"1625","Yarely","F","132","126",258
"1706","Yamilet","F","124","134",258
"1738","Gitty","F","120","138",258
"1867","Novah","F","110","148",258
"1489","Aaleyah","F","153","104",257
"1606","Karoline","F","133","124",257
"1623","Kayley","F","132","125",257
"1634","Sia","F","131","126",257
"1637","Althea","F","130","127",257
"1691","Isha","F","125","132",257
"1794","Ivey","F","116","141",257
"1823","Oakleigh","F","114","143",257
"1570","Cosette","F","139","117",256
"1616","Arabelle","F","132","124",256
"1674","Raeleigh","F","127","129",256
"1679","Julietta","F","126","130",256
"1750","Liah","F","119","137",256
"1331","Kaitlin","F","177","78",255
"1580","Jude","F","138","117",255
"1656","Shania","F","129","126",255
"1538","Maiya","F","145","109",254
"1676","Adaleigh","F","126","128",254
"1726","Keren","F","121","133",254
"1813","Magdalene","F","115","139",254
"1652","Avril","F","129","124",253
"1687","Camdyn","F","125","128",253
"1930","Artemis","F","104","149",253
"1587","Unique","F","137","115",252
"1590","Makiyah","F","136","116",252
"1776","Amal","F","117","135",252
"1798","Kinzlee","F","116","136",252
"1553","Kacie","F","141","110",251
"1602","Serafina","F","134","117",251
"1618","Cattleya","F","132","119",251
"1595","Rosalynn","F","135","115",250
"1596","Taelyn","F","135","115",250
"1698","Stormy","F","125","125",250
"1699","Alyse","F","124","126",250
"1711","Kenzlee","F","123","127",250
"1712","Rileigh","F","123","127",250
"1830","Kalina","F","113","137",250
"1833","Soleil","F","113","137",250
"1594","Jiselle","F","135","114",249
"1665","Sana","F","128","121",249
"1720","Rilee","F","122","127",249
"1728","Rhylee","F","121","128",249
"1786","Tala","F","117","132",249
"1546","Korra","F","143","105",248
"1603","Wilhelmina","F","134","114",248
"1611","Rosemarie","F","133","115",248
"1613","Ryder","F","133","115",248
"1632","Moira","F","131","117",248
"1832","Sanaya","F","113","135",248
"1761","Carol","F","118","129",247
"1782","Mazie","F","117","130",247
"1812","Lucero","F","115","132",247
"2061","Joey","F","95","152",247
"1828","Asiya","F","113","133",246
"1576","Presleigh","F","139","106",245
"1647","Saphira","F","130","115",245
"1707","Alyanna","F","123","122",245
"1754","Samia","F","119","126",245
"1875","Laylani","F","109","136",245
"1672","Melia","F","127","117",244
"1693","Khalia","F","125","119",244
"1703","Salome","F","124","120",244
"1749","Josslyn","F","119","125",244
"1800","Leanne","F","116","128",244
"1849","Candice","F","111","133",244
"1651","Avarie","F","129","114",243
"1654","Keegan","F","129","114",243
"1768","Kingsley","F","118","125",243
"1806","Arwen","F","115","128",243
"1850","Chiara","F","111","132",243
"1895","Khadijah","F","107","136",243
"1916","Beatriz","F","105","138",243
"1566","Zaira","F","140","102",242
"1736","Elisha","F","120","122",242
"1811","Hudson","F","115","127",242
"1918","Jolee","F","105","137",242
"1565","Shyanne","F","140","101",241
"1759","Yvonne","F","119","122",241
"1805","Ameera","F","115","126",241
"1866","Maelynn","F","110","131",241
"1629","Jaya","F","131","109",240
"1668","Amyah","F","127","113",240
"1692","Karolina","F","125","115",240
"1695","Liza","F","125","115",240
"1785","Samaya","F","117","123",240
"1831","Klara","F","113","127",240
"1645","Oona","F","130","109",239
"1678","Izabel","F","126","113",239
"1697","Skylee","F","125","114",239
"1560","Alanis","F","140","98",238
"1677","Aubreigh","F","126","112",238
"1713","Savanah","F","123","115",238
"1739","Indigo","F","120","118",238
"1655","Maliya","F","129","108",237
"1701","Baila","F","124","113",237
"1704","Sheila","F","124","113",237
"1705","Susana","F","124","113",237
"1709","Eryn","F","123","114",237
"1716","Emoni","F","122","115",237
"1747","Zinnia","F","120","117",237
"1790","Blanca","F","116","121",237
"1615","Annamarie","F","132","104",236
"1646","Precious","F","130","106",236
"1766","Jianna","F","118","118",236
"1774","Zarah","F","118","118",236
"2000","Loyalty","F","99","137",236
"1649","Adyson","F","129","106",235
"1745","Sahana","F","120","115",235
"2306","Merritt","F","81","154",235
"1604","Zaniya","F","134","100",234
"1675","Roxana","F","127","107",234
"1777","Amberly","F","117","117",234
"1871","Faigy","F","109","125",234
"1914","Aryah","F","105","129",234
"1920","Kyah","F","105","129",234
"1923","Roselynn","F","105","129",234
"1581","Kierra","F","138","95",233
"1642","Inara","F","130","103",233
"1685","Anaiah","F","125","108",233
"1797","Kenzley","F","116","117",233
"1807","Cori","F","115","118",233
"1905","Emberlynn","F","106","127",233
"1929","Aditi","F","104","129",233
"1857","Cooper","F","110","122",232
"1906","Hollis","F","106","126",232
"1658","Abrianna","F","128","103",231
"1686","Betsy","F","125","106",231
"1715","Elliette","F","122","109",231
"1744","Niya","F","120","111",231
"1729","Shayna","F","121","109",230
"1730","Tayla","F","121","109",230
"1755","Santana","F","119","111",230
"1827","Ashly","F","113","117",230
"1858","Darby","F","110","120",230
"1953","Marcela","F","103","127",230
"1683","Zuleyka","F","126","103",229
"1927","Yael","F","105","124",229
"1928","Yusra","F","105","124",229
"1771","Nechama","F","118","110",228
"1837","Carmela","F","112","116",228
"1863","Journei","F","110","118",228
"1921","Mariajose","F","105","123",228
"1666","Shae","F","128","99",227
"1690","Deja","F","125","102",227
"1846","Abygail","F","111","116",227
"1876","Lois","F","109","118",227
"2117","Majesty","F","91","136",227
"1627","Desirae","F","131","95",226
"1640","Brigitte","F","130","96",226
"1795","Justyce","F","116","110",226
"1836","Aleyna","F","112","114",226
"1839","Iyla","F","112","114",226
"1853","Navya","F","111","115",226
"1884","Kamdyn","F","108","118",226
"1885","Layna","F","108","118",226
"1897","Mona","F","107","119",226
"2011","Dream","F","98","128",226
"1702","Christian","F","124","101",225
"1710","Honor","F","123","102",225
"1727","Nelly","F","121","104",225
"1737","Gillian","F","120","105",225
"1802","Mileena","F","116","109",225
"1815","Paizley","F","115","110",225
"1873","Katia","F","109","116",225
"1973","Laikyn","F","101","124",225
"2028","Ripley","F","97","128",225
"1610","Nikki","F","133","91",224
"1717","Jamya","F","122","102",224
"1793","Elouise","F","116","108",224
"1843","Nichole","F","112","112",224
"1881","Berkeley","F","108","116",224
"1908","Jamila","F","106","118",224
"1919","Juana","F","105","119",224
"1752","Reem","F","119","104",223
"1765","Georgiana","F","118","105",223
"1801","Maryann","F","116","107",223
"1840","Jaina","F","112","111",223
"1842","Mariel","F","112","111",223
"1877","Violetta","F","109","114",223
"1880","Annalisa","F","108","115",223
"1893","Fatimah","F","107","116",223
"1955","Oriana","F","103","120",223
"2012","Iva","F","98","125",223
"1671","Kaylah","F","127","95",222
"1689","Daria","F","125","97",222
"1714","Chelsey","F","122","100",222
"1746","Sahara","F","120","102",222
"1760","Ariyanna","F","118","104",222
"1778","Aviva","F","117","105",222
"1780","Jalayah","F","117","105",222
"1783","Nila","F","117","105",222
"1838","Gentry","F","112","110",222
"1851","Ester","F","111","111",222
"2024","Ira","F","97","125",222
"1630","Laci","F","131","90",221
"1694","Krista","F","125","96",221
"1819","Graciela","F","114","107",221
"1968","Rhyan","F","102","119",221
"2101","Isobel","F","92","129",221
"2130","Melania","F","90","131",221
"1723","Chyna","F","121","99",220
"1784","Raniyah","F","117","103",220
"1787","Aiza","F","116","104",220
"1816","Abigale","F","114","106",220
"1820","Jaylani","F","114","106",220
"1845","Tiara","F","112","108",220
"1886","Loren","F","108","112",220
"1978","Stacey","F","101","119",220
"2056","Gracen","F","95","125",220
"1735","Cayla","F","120","99",219
"1639","Ariyana","F","130","88",218
"1741","Janiah","F","120","98",218
"1891","Braylynn","F","107","111",218
"1980","Analeah","F","100","118",218
"1824","Rori","F","114","103",217
"1904","Emberlyn","F","106","111",217
"1926","Valencia","F","105","112",217
"1933","Elyssa","F","104","113",217
"1722","Alyna","F","121","95",216
"1748","Channing","F","119","97",216
"1751","Melodie","F","119","97",216
"1767","Joslynn","F","118","98",216
"1818","Colleen","F","114","102",216
"1864","Kianna","F","110","106",216
"1909","Johana","F","106","110",216
"1948","Avia","F","103","113",216
"1961","Jaycie","F","102","114",216
"2240","Sterling","F","84","132",216
"3065","Oaklyn","F","55","161",216
"1872","Jadyn","F","109","106",215
"2001","Lula","F","99","116",215
"2097","Brynnlee","F","92","123",215
"2108","Amarah","F","91","124",215
"2281","Kamya","F","82","133",215
"1725","Karmyn","F","121","93",214
"1781","Makenzi","F","117","97",214
"1821","Jessalyn","F","114","100",214
"1844","Shoshana","F","112","102",214
"1859","Devin","F","110","104",214
"1888","Adalynne","F","107","107",214
"1924","Sumaya","F","105","109",214
"1963","Kennadi","F","102","112",214
"1650","Ariane","F","129","84",213
"1773","Taniyah","F","118","95",213
"1817","Brea","F","114","99",213
"1829","Echo","F","113","100",213
"1868","Tanvi","F","110","103",213
"1970","Gina","F","101","112",213
"2039","Harleen","F","96","117",213
"1758","Yasmeen","F","119","93",212
"1791","Brookelynn","F","116","96",212
"1825","Xitlali","F","114","98",212
"1896","Lynlee","F","107","105",212
"1957","Rochel","F","103","109",212
"1960","Hafsa","F","102","110",212
"2132","Adalind","F","89","123",212
"2138","Emrie","F","89","123",212
"2157","Murphy","F","88","124",212
"1772","Payten","F","118","93",211
"1799","Laniya","F","116","95",211
"1822","Kari","F","114","97",211
"1910","Kaliah","F","106","105",211
"1938","Mackenna","F","104","107",211
"1991","Marianne","F","100","111",211
"1994","Angely","F","99","112",211
"1997","Joan","F","99","112",211
"2022","Inaya","F","97","114",211
"1834","Viktoria","F","113","97",210
"1865","Love","F","110","100",210
"1934","Iman","F","104","106",210
"1937","Lettie","F","104","106",210
"2009","Avigail","F","98","112",210
"2060","Jiya","F","95","115",210
"2213","Kamiah","F","85","125",210
"1969","Dora","F","101","108",209
"2123","Eiza","F","90","119",209
"2129","Maddox","F","90","119",209
"1718","Jordin","F","122","86",208
"1721","Yulissa","F","122","86",208
"1769","Kloe","F","118","90",208
"1856","Brittney","F","110","98",208
"1999","Leen","F","99","109",208
"1902","Zayda","F","107","100",207
"1903","Annmarie","F","106","101",207
"1947","Annalynn","F","103","104",207
"2065","Malky","F","95","112",207
"2087","Citlali","F","93","114",207
"1854","Vaida","F","111","95",206
"1874","Khloee","F","109","97",206
"1901","Yolanda","F","107","99",206
"1943","Safa","F","104","102",206
"1808","Dianna","F","115","90",205
"1887","Marisa","F","108","97",205
"1900","Taelynn","F","107","98",205
"2189","Inaaya","F","86","119",205
"1731","Taylin","F","121","83",204
"1804","Taytum","F","116","88",204
"1889","Aleeah","F","107","97",204
"1922","Maycee","F","105","99",204
"2095","Xena","F","93","111",204
"1622","Jackeline","F","132","71",203
"1740","Jamiya","F","120","83",203
"1788","Anisa","F","116","87",203
"1855","Armoni","F","110","93",203
"1892","Emelyn","F","107","96",203
"1907","Italia","F","106","97",203
"1949","Brighton","F","103","100",203
"1962","Justine","F","102","101",203
"1988","Josselyn","F","100","103",203
"2054","Chava","F","95","108",203
"2148","Arizona","F","88","115",203
"2008","Aoife","F","98","104",202
"2063","Lailani","F","95","107",202
"2152","Josephina","F","88","114",202
"2207","Doris","F","85","117",202
"2262","Millicent","F","83","119",202
"1826","Ashleigh","F","113","88",201
"2048","Naila","F","96","105",201
"2182","Teigan","F","87","114",201
"2188","Haidyn","F","86","115",201
"2004","Merida","F","99","101",200
"2007","Anylah","F","98","102",200
"2070","Sydnee","F","95","105",200
"2080","Sabina","F","94","106",200
"2156","Milly","F","88","112",200
"1796","Kayli","F","116","83",199
"1915","Ashlee","F","105","94",199
"1985","Irelynn","F","100","99",199
"1989","Lux","F","100","99",199
"1996","Ela","F","99","100",199
"1998","Lakelyn","F","99","100",199
"2006","Trisha","F","99","100",199
"2018","Alonna","F","97","102",199
"2035","Caliyah","F","96","103",199
"1734","Brylie","F","120","78",198
"1913","Arie","F","105","93",198
"1939","Maelyn","F","104","94",198
"1951","Deasia","F","103","95",198
"2105","Rosalinda","F","92","106",198
"2263","Ramsey","F","83","115",198
"1883","Jaslynn","F","108","89",197
"1894","Jaiden","F","107","90",197
"1925","Tanya","F","105","92",197
"1964","Laina","F","102","95",197
"1966","Makinley","F","102","95",197
"1972","Kiyah","F","101","96",197
"2016","Laya","F","98","99",197
"2029","Zyla","F","97","100",197
"2085","Asma","F","93","104",197
"2149","Avalee","F","88","109",197
"1835","Aleksandra","F","112","84",196
"1847","Adalia","F","111","85",196
"1879","Adleigh","F","108","88",196
"1898","Niyah","F","107","89",196
"1940","Memphis","F","104","92",196
"1986","Italy","F","100","96",196
"2064","Maddilyn","F","95","101",196
"1890","Aleyah","F","107","88",195
"1967","Marli","F","102","93",195
"2072","Amerie","F","94","101",195
"2089","Devorah","F","93","102",195
"2131","Sybil","F","90","105",195
"2241","Taleah","F","84","111",195
"1861","Ever","F","110","84",194
"1862","Finleigh","F","110","84",194
"1944","Shaniya","F","104","90",194
"1956","Raelee","F","103","91",194
"1976","Paizlee","F","101","93",194
"2026","Kavya","F","97","97",194
"2040","Irina","F","96","98",194
"2253","Glory","F","83","111",194
"2336","Goldie","F","79","115",194
"1841","Laiyah","F","112","81",193
"1958","Talya","F","103","90",193
"2020","Billie","F","97","96",193
"2053","Alyana","F","95","98",193
"2073","Aura","F","94","99",193
"2098","Diane","F","92","101",193
"2104","Pippa","F","92","101",193
"2113","Janyla","F","91","102",193
"2114","Kaira","F","91","102",193
"2235","Lillith","F","84","109",193
"2298","Emmi","F","81","112",193
"1848","Aislyn","F","111","81",192
"1911","Sandy","F","106","86",192
"1995","Beckett","F","99","93",192
"2030","Aeris","F","96","96",192
"2079","Rylin","F","94","98",192
"2109","Aniah","F","91","101",192
"2142","Liya","F","89","103",192
"2237","Ria","F","84","108",192
"1931","Bennett","F","104","87",191
"1971","Kalli","F","101","90",191
"2154","Kodi","F","88","103",191
"2176","Maryn","F","87","104",191
"2203","Anissa","F","85","106",191
"1965","Lluvia","F","102","88",190
"1977","Rania","F","101","89",190
"1982","Cristal","F","100","90",190
"1984","Fabiola","F","100","90",190
"2042","Joanne","F","96","94",190
"2100","Gaia","F","92","98",190
"2111","Elyana","F","91","99",190
"2122","Candace","F","90","100",190
"2243","Adrian","F","83","107",190
"1870","Cierra","F","109","80",189
"1882","Brandi","F","108","81",189
"2078","Noella","F","94","95",189
"2084","Analee","F","93","96",189
"2090","Hayven","F","93","96",189
"2093","Rain","F","93","96",189
"2099","Evelin","F","92","97",189
"2128","Lourdes","F","90","99",189
"2195","Mari","F","86","103",189
"2210","Emeline","F","85","104",189
"1860","Emalee","F","110","78",188
"1917","Jacelyn","F","105","83",188
"1935","Jacie","F","104","84",188
"1941","Myka","F","104","84",188
"1946","Acacia","F","103","85",188
"1959","Vicky","F","103","85",188
"1979","Yana","F","101","87",188
"2036","Elli","F","96","92",188
"2043","Khali","F","96","92",188
"2094","Terra","F","93","95",188
"2183","Zyana","F","87","101",188
"2211","Gizelle","F","85","103",188
"1936","Keeley","F","104","83",187
"1992","Raizy","F","100","87",187
"2002","Makaylah","F","99","88",187
"2049","Roxanna","F","96","91",187
"2058","Jaidyn","F","95","92",187
"2134","Amarie","F","89","98",187
"1852","Kristin","F","111","75",186
"2033","Brystol","F","96","90",186
"2088","Dafne","F","93","93",186
"2144","Raine","F","89","97",186
"2145","Reilly","F","89","97",186
"2151","Greer","F","88","98",186
"2332","Theodora","F","80","106",186
"2482","Maple","F","73","113",186
"1974","Lanie","F","101","84",185
"2037","Emmaleigh","F","96","89",185
"2074","Jackie","F","94","91",185
"2086","Audrie","F","93","92",185
"2191","Juno","F","86","99",185
"2264","Rebel","F","83","102",185
"2285","Leylani","F","82","103",185
"1952","Korie","F","103","81",184
"2013","Keely","F","98","86",184
"2027","Nour","F","97","87",184
"2041","Jaci","F","96","88",184
"2046","Lynette","F","96","88",184
"2057","Jacklyn","F","95","89",184
"2216","Manha","F","85","99",184
"1954","Maylin","F","103","80",183
"2015","Lane","F","98","85",183
"2019","Ansleigh","F","97","86",183
"2021","Evan","F","97","86",183
"2083","Amaria","F","93","90",183
"2107","Star","F","92","91",183
"2112","Jannah","F","91","92",183
"2160","Selma","F","88","95",183
"2164","Amor","F","87","96",183
"2168","Ellia","F","87","96",183
"2273","Daenerys","F","82","101",183
"2291","Aaradhya","F","81","102",183
"1990","Malena","F","100","82",182
"1993","Aminata","F","99","83",182
"2047","Marwa","F","96","86",182
"2139","Harlem","F","89","93",182
"2202","Analeigh","F","85","97",182
"2293","Ameerah","F","81","101",182
"1775","Aleyda","F","117","64",181
"1983","Elysia","F","100","81",181
"2010","Dawn","F","98","83",181
"2096","Brissa","F","92","89",181
"2143","Mayte","F","89","92",181
"2180","Sheyla","F","87","94",181
"2205","Aylah","F","85","96",181
"2238","Ryley","F","84","97",181
"2251","Giulia","F","83","98",181
"2289","Yatziri","F","82","99",181
"2005","Mirabelle","F","99","81",180
"2023","Ines","F","97","83",180
"2136","Avamarie","F","89","91",180
"2192","Leora","F","86","94",180
"2208","Eila","F","85","95",180
"2031","Afton","F","96","83",179
"2055","Dasha","F","95","84",179
"2077","Naia","F","94","85",179
"2102","Mason","F","92","87",179
"2116","Maelee","F","91","88",179
"2150","Baileigh","F","88","91",179
"2159","Rian","F","88","91",179
"2708","Harlynn","F","65","114",179
"1942","Rocio","F","104","74",178
"2051","Xochitl","F","96","82",178
"2181","Sol","F","87","91",178
"2356","Lottie","F","78","100",178
"2470","Berklee","F","73","105",178
"2486","Pia","F","73","105",178
"2014","Kerrigan","F","98","79",177
"2075","Josefina","F","94","83",177
"2081","Susie","F","94","83",177
"2124","Eleanore","F","90","87",177
"2215","Laine","F","85","92",177
"2261","Mckinlee","F","83","94",177
"2423","Cayleigh","F","75","102",177
"1878","Abigayle","F","108","68",176
"2052","Allisson","F","95","81",176
"2115","Kynzlee","F","91","85",176
"2217","Marlow","F","85","91",176
"2219","Sonja","F","85","91",176
"2229","Jailynn","F","84","92",176
"1945","Abagail","F","103","72",175
"2153","Kiya","F","88","87",175
"2236","Neva","F","84","91",175
"2267","Tracy","F","83","92",175
"2384","Kenslee","F","77","98",175
"2551","Desire","F","70","105",175
"2025","Jeanette","F","97","77",174
"2076","Kyler","F","94","80",174
"2135","Aubry","F","89","85",174
"2163","Ameena","F","87","87",174
"2178","Perry","F","87","87",174
"2231","Jia","F","84","90",174
"2242","Adelia","F","83","91",174
"2286","Lynn","F","82","92",174
"2302","Larkin","F","81","93",174
"2310","Susannah","F","81","93",174
"2003","Mariya","F","99","74",173
"2050","Stefany","F","96","77",173
"2066","Paulette","F","95","78",173
"2290","Zayna","F","82","91",173
"2441","Theia","F","75","98",173
"1912","Arayah","F","105","67",172
"2044","Lesley","F","96","76",172
"2059","Janelly","F","95","77",172
"2121","Avonlea","F","90","82",172
"2147","Aarohi","F","88","84",172
"2167","Avaya","F","87","85",172
"2173","Katheryn","F","87","85",172
"2187","Fern","F","86","86",172
"2214","Krisha","F","85","87",172
"2234","Kaniyah","F","84","88",172
"2247","Calli","F","83","89",172
"2270","Braylin","F","82","90",172
"2335","Debora","F","79","93",172
"2387","Maizie","F","77","95",172
"2395","Sahasra","F","77","95",172
"2438","Rahma","F","75","97",172
"2462","Klaire","F","74","98",172
"2103","Olyvia","F","92","79",171
"2119","Adah","F","90","81",171
"2204","Aven","F","85","86",171
"2223","Alayla","F","84","87",171
"2269","Anisha","F","82","89",171
"2274","Delylah","F","82","89",171
"2295","Avelyn","F","81","90",171
"2300","Jayne","F","81","90",171
"2325","Hellen","F","80","91",171
"2452","Evalina","F","74","97",171
"2685","Jules","F","66","105",171
"1779","Isis","F","117","53",170
"1950","Daleysa","F","103","67",170
"2062","Juanita","F","95","75",170
"2069","Sabine","F","95","75",170
"2161","Zariya","F","88","82",170
"2255","Ilana","F","83","87",170
"2360","Philomena","F","78","92",170
"3025","Blayke","F","56","114",170
"1987","Iyana","F","100","69",169
"2038","Estela","F","96","73",169
"2155","Lilyan","F","88","81",169
"2169","Hawa","F","87","82",169
"2199","Adelle","F","85","84",169
"2277","Janna","F","82","87",169
"2305","Lotus","F","81","88",169
"2330","Mayla","F","80","89",169
"2346","Ani","F","78","91",169
"2389","Marlo","F","77","92",169
"2397","Yuri","F","77","92",169
"2434","Lilyanne","F","75","94",169
"2125","Jannat","F","90","78",168
"2317","Annalia","F","80","88",168
"2082","Taylee","F","94","73",167
"2137","Destini","F","89","78",167
"2140","Janeth","F","89","78",167
"2193","Lupita","F","86","81",167
"2296","Charly","F","81","86",167
"2309","Sevyn","F","81","86",167
"2345","Amiracle","F","78","89",167
"2357","Lucianna","F","78","89",167
"2374","Asiyah","F","77","90",167
"2473","Fatoumata","F","73","94",167
"2032","Arionna","F","96","70",166
"2091","Kelis","F","93","73",166
"2118","Sanvi","F","91","75",166
"2186","Eliora","F","86","80",166
"2256","Jalynn","F","83","83",166
"2275","Flor","F","82","84",166
"2358","Mindy","F","78","88",166
"3835","Arlet","F","39","127",166
"2166","Avary","F","87","78",165
"2177","Mildred","F","87","78",165
"2287","Tamar","F","82","83",165
"2292","Addelynn","F","81","84",165
"2319","Aribella","F","80","85",165
"2338","Kelsi","F","79","86",165
"2340","Skarlett","F","79","86",165
"2359","Noelani","F","78","87",165
"2363","Rivky","F","78","87",165
"2463","Layah","F","74","91",165
"2126","Jenelle","F","90","74",164
"2165","Annaleah","F","87","77",164
"2196","Odette","F","86","78",164
"2254","Hollie","F","83","81",164
"2299","Jaden","F","81","83",164
"2351","Corina","F","78","86",164
"2352","Divine","F","78","86",164
"2454","Jamia","F","74","90",164
"2509","Jesslyn","F","72","92",164
"2034","Caelyn","F","96","67",163
"2045","Liyah","F","96","67",163
"2071","Zarina","F","95","68",163
"2092","Nikita","F","93","70",163
"2127","Layne","F","90","73",163
"2162","Agatha","F","87","76",163
"2171","Jennah","F","87","76",163
"2209","Ellington","F","85","78",163
"2226","Danni","F","84","79",163
"2227","Eternity","F","84","79",163
"2230","Jazzlynn","F","84","79",163
"2288","Tilly","F","82","81",163
"2327","Mahogany","F","80","83",163
"2391","Norma","F","77","86",163
"2412","Romy","F","76","87",163
"2439","Shira","F","75","88",163
"2683","Jailyne","F","66","97",163
"2756","Nariyah","F","64","99",163
"2776","Haisley","F","63","100",163
"2808","Giulietta","F","62","101",163
"2175","Maizy","F","87","75",162
"2198","Triniti","F","86","76",162
"2225","Batsheva","F","84","78",162
"2265","Sinai","F","83","79",162
"2361","Priscila","F","78","84",162
"2640","Analy","F","67","95",162
"1975","Monique","F","101","60",161
"2218","Mylee","F","85","76",161
"2415","Storm","F","76","85",161
"2571","Abilene","F","69","92",161
"2581","Isley","F","69","92",161
"2639","Adalyne","F","67","94",161
"2681","Empress","F","66","95",161
"2742","Ileana","F","64","97",161
"2017","Veronika","F","98","62",160
"2110","Bracha","F","91","69",160
"2120","Anayeli","F","90","70",160
"2257","Kalena","F","83","77",160
"2308","Sariya","F","81","79",160
"2339","Mallorie","F","79","81",160
"2394","Rilyn","F","77","83",160
"2399","Aisley","F","76","84",160
"2550","Collette","F","70","90",160
"2600","Paxton","F","69","91",160
"2662","Marigold","F","67","93",160
"2221","Vianney","F","85","74",159
"2313","Zaida","F","81","78",159
"2333","Toby","F","80","79",159
"3008","Oaklynn","F","57","102",159
"2158","Nyasia","F","88","70",158
"2233","Kambree","F","84","74",158
"2304","Lexington","F","81","77",158
"2320","Brigid","F","80","78",158
"2323","Emarie","F","80","78",158
"2365","Samaira","F","78","80",158
"2464","Nirvana","F","74","84",158
"2478","Jovi","F","73","85",158
"2774","Emberlee","F","63","95",158
"2172","Joi","F","87","70",157
"2259","Linley","F","83","74",157
"2311","Taylynn","F","81","76",157
"2315","Ania","F","80","77",157
"2498","Anastacia","F","72","85",157
"2507","Ivie","F","72","85",157
"2517","Saira","F","72","85",157
"2527","Emmersyn","F","71","86",157
"2892","Haniya","F","60","97",157
"2067","Rachelle","F","95","61",156
"2190","Joann","F","86","70",156
"2200","Alaiyah","F","85","71",156
"2329","Marguerite","F","80","76",156
"2367","Shaina","F","78","78",156
"2385","Kristine","F","77","79",156
"2404","Edna","F","76","80",156
"2465","Randi","F","74","82",156
"2476","Indiana","F","73","83",156
"2526","Ellyana","F","71","85",156
"2696","Zoee","F","66","90",156
"2206","Charis","F","85","70",155
"2224","Annemarie","F","84","71",155
"2272","Connie","F","82","73",155
"2324","Evolet","F","80","75",155
"2393","Preslie","F","77","78",155
"2431","Jayna","F","75","80",155
"2446","Adlee","F","74","81",155
"2530","Isela","F","71","84",155
"2619","Chesney","F","68","87",155
"2634","Safiya","F","68","87",155
"2653","Joselin","F","67","88",155
"2174","Kimberlyn","F","87","67",154
"2228","Fallyn","F","84","70",154
"2252","Gladys","F","83","71",154
"2283","Keiry","F","82","72",154
"2380","Ericka","F","77","77",154
"2408","Jayleigh","F","76","78",154
"2426","Draya","F","75","79",154
"2524","Brook","F","71","83",154
"2540","Ridley","F","71","83",154
"2541","Sabella","F","71","83",154
"2170","Jalaya","F","87","66",153
"2179","Rayven","F","87","66",153
"2284","Kenzleigh","F","82","71",153
"2297","Cienna","F","81","72",153
"2371","Alexi","F","77","76",153
"2409","Josey","F","76","77",153
"2435","Liyana","F","75","78",153
"2497","Analiyah","F","72","81",153
"2568","Venus","F","70","83",153
"2618","Cailey","F","68","85",153
"2745","Jayce","F","64","89",153
"2106","Samaria","F","92","60",152
"2197","Saydee","F","86","66",152
"2266","Timber","F","83","69",152
"2278","Jasleen","F","82","70",152
"2316","Anistyn","F","80","72",152
"2328","Marbella","F","80","72",152
"2411","Landyn","F","76","76",152
"2514","Marlena","F","72","80",152
"2554","Janaya","F","70","82",152
"2621","Elowyn","F","68","84",152
"2836","Austen","F","61","91",152
"2245","Alyza","F","83","68",151
"2314","Anasofia","F","80","71",151
"2322","Calleigh","F","80","71",151
"2353","Joana","F","78","73",151
"2437","Odessa","F","75","76",151
"2466","Abella","F","73","78",151
"2485","Naveah","F","73","78",151
"2594","Mandy","F","69","82",151
"2603","Rosario","F","69","82",151
"2661","Liz","F","67","84",151
"2697","Anali","F","65","86",151
"2141","Katharine","F","89","61",150
"2212","Jhene","F","85","65",150
"2321","Bryce","F","80","70",150
"2341","Tristan","F","79","71",150
"2421","Berlin","F","75","75",150
"2516","Rylei","F","72","78",150
"2565","Sullivan","F","70","80",150
"2246","Breelyn","F","83","66",149
"2303","Leann","F","81","68",149
"2416","Yadira","F","76","73",149
"2442","Vianey","F","75","74",149
"2450","Avyanna","F","74","75",149
"2531","Karely","F","71","78",149
"2547","Bethel","F","70","79",149
"2828","Zofia","F","62","87",149
"3113","Ziya","F","54","95",149
"2133","Alli","F","89","59",148
"2184","Brooklynne","F","86","62",148
"2260","Loralei","F","83","65",148
"2294","Arianne","F","81","67",148
"2369","Swara","F","78","70",148
"2390","Misha","F","77","71",148
"2512","Lexy","F","72","76",148
"2538","Miller","F","71","77",148
"2542","Serene","F","71","77",148
"2580","Haya","F","69","79",148
"2601","Prudence","F","69","79",148
"2628","Luca","F","68","80",148
"2676","Dawson","F","66","82",148
"2809","Inez","F","62","86",148
"4014","Ivanka","F","37","111",148
"2220","Taniya","F","85","62",147
"2343","Ainslee","F","78","69",147
"2417","Zakiyah","F","76","71",147
"2424","Coralee","F","75","72",147
"2528","Ensley","F","71","76",147
"2578","Eowyn","F","69","78",147
"2635","Stormie","F","68","79",147
"2721","Ocean","F","65","82",147
"2727","Aleia","F","64","83",147
"2791","Sama","F","63","84",147
"2842","Elliotte","F","61","86",147
"2942","Laiken","F","59","88",147
"2965","Berenice","F","58","89",147
"2983","Nahomi","F","58","89",147
"2222","Aja","F","84","62",146
"2250","Emalynn","F","83","63",146
"2318","Anvi","F","80","66",146
"2348","Antoinette","F","78","68",146
"2373","Anslee","F","77","69",146
"2443","Yocheved","F","75","71",146
"2539","Ravyn","F","71","75",146
"2646","Damiyah","F","67","79",146
"2675","Brandy","F","66","80",146
"2777","Karson","F","63","83",146
"2362","Raylin","F","78","67",145
"2414","Shyann","F","76","69",145
"2436","Lyrik","F","75","70",145
"2449","Asher","F","74","71",145
"2493","Aaralyn","F","72","73",145
"2506","Isa","F","72","73",145
"2513","Leyna","F","72","73",145
"2585","Jamiah","F","69","76",145
"2623","Finlee","F","68","77",145
"2645","Camellia","F","67","78",145
"2650","Eris","F","67","78",145
"2326","Lillyan","F","80","64",144
"2370","Ainara","F","77","67",144
"2379","Elisheva","F","77","67",144
"2396","Suzanne","F","77","67",144
"2468","Anja","F","73","71",144
"2481","Magaly","F","73","71",144
"2613","Aly","F","68","76",144
"2689","Lani","F","66","78",144
"2733","Birdie","F","64","80",144
"2185","Danae","F","86","57",143
"2248","Christy","F","83","60",143
"2249","Coco","F","83","60",143
"2271","Carys","F","82","61",143
"2279","Jasmyn","F","82","61",143
"2354","Laynie","F","78","65",143
"2355","Linden","F","78","65",143
"2364","Ruhi","F","78","65",143
"2381","Giulianna","F","77","66",143
"2419","Anaiya","F","75","68",143
"2453","Illiana","F","74","69",143
"2492","Zipporah","F","73","70",143
"2522","Alysson","F","71","72",143
"2552","Emilyn","F","70","73",143
"2599","Niah","F","69","74",143
"2607","Tayler","F","69","74",143
"2674","Blakelyn","F","66","77",143
"2711","Irelyn","F","65","78",143
"2723","Yitty","F","65","78",143
"2741","Francis","F","64","79",143
"2853","Lavender","F","61","82",143
"2194","Makaila","F","86","56",142
"2475","Halima","F","73","69",142
"2490","Shriya","F","73","69",142
"2561","Lilli","F","70","72",142
"2615","Aziyah","F","68","74",142
"2616","Blakelee","F","68","74",142
"2647","Dayanara","F","67","75",142
"2652","Jean","F","67","75",142
"2717","Kynsley","F","65","77",142
"2762","Aizah","F","63","79",142
"2793","Therese","F","63","79",142
"2337","Kaylene","F","79","62",141
"2376","Brookelyn","F","77","64",141
"2402","Chanelle","F","76","65",141
"2499","Annalie","F","72","69",141
"2533","Kyrah","F","71","70",141
"2535","Mabry","F","71","70",141
"2566","Tillie","F","70","71",141
"2586","Jenevieve","F","69","72",141
"2596","Melisa","F","69","72",141
"2622","Emmylou","F","68","73",141
"2657","Khaliyah","F","67","74",141
"2673","Auria","F","66","75",141
"2709","Harmonee","F","65","76",141
"2738","Edyn","F","64","77",141
"2795","Wyatt","F","63","78",141
"2815","Landrie","F","62","79",141
"2201","Alexus","F","85","55",140
"2258","Kinzie","F","83","57",140
"2375","Brianne","F","77","63",140
"2388","Malinda","F","77","63",140
"2418","Alona","F","75","65",140
"2502","Cerenity","F","72","68",140
"2546","Baylie","F","70","70",140
"2664","Polina","F","67","73",140
"2932","Esmae","F","59","81",140
"3018","Adelyne","F","56","84",140
"2239","Shaniyah","F","84","55",139
"2244","Alijah","F","83","56",139
"2347","Annalyse","F","78","61",139
"2350","Britton","F","78","61",139
"2413","Savana","F","76","63",139
"2422","Briseida","F","75","64",139
"2459","Kassie","F","74","65",139
"2461","Khylee","F","74","65",139
"2489","Shaila","F","73","66",139
"2543","Simran","F","71","68",139
"2545","Adella","F","70","69",139
"2625","Ilyana","F","68","71",139
"2734","Brie","F","64","75",139
"2798","Ahuva","F","62","77",139
"2919","Ayra","F","59","80",139
"3102","Malika","F","54","85",139
"2331","Roxy","F","80","58",138
"2342","Zooey","F","79","59",138
"2366","Shaelyn","F","78","60",138
"2377","Brynnley","F","77","61",138
"2378","Devon","F","77","61",138
"2392","Pauline","F","77","61",138
"2401","Avaleigh","F","76","62",138
"2425","Dasia","F","75","63",138
"2479","Kennady","F","73","65",138
"2525","Brynna","F","71","67",138
"2557","Julieth","F","70","68",138
"2576","Daliyah","F","69","69",138
"2589","Kaiyah","F","69","69",138
"2602","Rosabella","F","69","69",138
"2651","Irma","F","67","71",138
"2679","Elani","F","66","72",138
"2702","Caia","F","65","73",138
"2780","Lavinia","F","63","75",138
"2349","Avni","F","78","59",137
"2372","Angelie","F","77","60",137
"2405","Emaan","F","76","61",137
"2487","Ryanne","F","73","64",137
"2500","Annalyn","F","72","65",137
"2555","Jariyah","F","70","67",137
"2556","Jordana","F","70","67",137
"2564","Royale","F","70","67",137
"2567","Tova","F","70","67",137
"2722","Shaindy","F","65","72",137
"2268","Yaiza","F","83","53",136
"2301","Kaydance","F","81","55",136
"2307","Milla","F","81","55",136
"2386","Lael","F","77","59",136
"2448","Anderson","F","74","62",136
"2451","Azlynn","F","74","62",136
"2534","Leana","F","71","65",136
"2544","Aalayah","F","70","66",136
"2588","Kaily","F","69","67",136
"2636","Story","F","68","68",136
"2706","Emaline","F","65","71",136
"2999","Jahzara","F","57","79",136
"3071","Samarah","F","55","81",136
"3078","Ziyah","F","55","81",136
"3284","Zelie","F","50","86",136
"2398","Adelynne","F","76","59",135
"2420","Anaiyah","F","75","60",135
"2494","Aashvi","F","72","63",135
"2518","Saya","F","72","63",135
"2529","Grey","F","71","64",135
"2563","Nilah","F","70","65",135
"2643","Bobbi","F","67","68",135
"2691","Marla","F","66","69",135
"2699","Aries","F","65","70",135
"2737","Dara","F","64","71",135
"2868","Philippa","F","61","74",135
"2916","Alycia","F","59","76",135
"2941","Kylar","F","59","76",135
"2232","Kalynn","F","84","50",134
"2403","Christianna","F","76","58",134
"2460","Kenadee","F","74","60",134
"2488","Sequoia","F","73","61",134
"2511","Kyara","F","72","62",134
"2562","Nava","F","70","64",134
"2587","Jesiah","F","69","65",134
"2631","Nika","F","68","66",134
"2654","Kamaria","F","67","67",134
"2695","Uma","F","66","68",134
"2754","Nahomy","F","64","70",134
"2972","Hosanna","F","58","76",134
"2977","Joella","F","58","76",134
"3013","Skai","F","57","77",134
"3296","Fiorella","F","49","85",134
"3516","Zailey","F","45","89",134
"2280","Jazmyne","F","82","51",133
"2282","Kaydee","F","82","51",133
"2334","Alyce","F","79","54",133
"2382","Kaileigh","F","77","56",133
"2440","Skylin","F","75","58",133
"2447","Aliviah","F","74","59",133
"2467","Adria","F","73","60",133
"2471","Blakeley","F","73","60",133
"2483","Mayar","F","73","60",133
"2605","Sedona","F","69","64",133
"2630","Minnie","F","68","65",133
"2918","Arina","F","59","74",133
"2975","Jayme","F","58","75",133
"3049","Anora","F","55","78",133
"2410","Kylynn","F","76","56",132
"2455","Jaslene","F","74","58",132
"2503","Easton","F","72","60",132
"2570","Yehudis","F","70","62",132
"2582","Issabella","F","69","63",132
"2633","Rikki","F","68","64",132
"2660","Lenore","F","67","65",132
"2672","Amna","F","66","66",132
"2680","Emmanuella","F","66","66",132
"2767","Avayah","F","63","69",132
"2835","Arrow","F","61","71",132
"2911","Verity","F","60","72",132
"3494","Khalani","F","45","87",132
"2276","Izel","F","82","49",131
"2429","Hadassa","F","75","56",131
"2472","Dakotah","F","73","58",131
"2508","Janely","F","72","59",131
"2553","Ivette","F","70","61",131
"2574","Becca","F","69","62",131
"2648","Elyza","F","67","64",131
"2668","Xyla","F","67","64",131
"2788","Rena","F","63","68",131
"2796","Adira","F","62","69",131
"2804","Crimson","F","62","69",131
"2344","Allegra","F","78","52",130
"2428","Gema","F","75","55",130
"2444","Acelynn","F","74","56",130
"2445","Adara","F","74","56",130
"2458","Kahlan","F","74","56",130
"2469","Ayden","F","73","57",130
"2521","Aleeyah","F","71","59",130
"2573","Aniylah","F","69","61",130
"2592","Lovely","F","69","61",130
"2598","Nataleigh","F","69","61",130
"2710","Huda","F","65","65",130
"2771","Chase","F","63","67",130
"2778","Kenadi","F","63","67",130
"2782","Luci","F","63","67",130
"2789","Rina","F","63","67",130
"2834","Alya","F","61","69",130
"2854","Leeann","F","61","69",130
"2866","Nalah","F","61","69",130
"2867","Nell","F","61","69",130
"2885","Christa","F","60","70",130
"3006","Maricela","F","57","73",130
"3079","Zylah","F","55","75",130
"3222","Kamaya","F","51","79",130
"3248","Charlette","F","50","80",130
"3372","Nessa","F","48","82",130
"2368","Sherry","F","78","51",129
"2548","Briseyda","F","70","59",129
"2579","Gianni","F","69","60",129
"2591","Kynnedi","F","69","60",129
"2617","Briseis","F","68","61",129
"2638","Yulianna","F","68","61",129
"2713","Joseline","F","65","64",129
"2746","Jesse","F","64","65",129
"2752","Makiya","F","64","65",129
"2785","Manuela","F","63","66",129
"2831","Alise","F","61","68",129
"2847","Jessi","F","61","68",129
"2858","Maddyn","F","61","68",129
"2886","Cianna","F","60","69",129
"3539","Grettel","F","44","85",129
"2474","Haiden","F","73","55",128
"2480","Kirra","F","73","55",128
"2491","Starr","F","73","55",128
"2504","Eliyah","F","72","56",128
"2537","Meagan","F","71","57",128
"2558","Keagan","F","70","58",128
"2575","Carrington","F","69","59",128
"2584","Jalissa","F","69","59",128
"2593","Maddisyn","F","69","59",128
"2610","Adrianne","F","68","60",128
"2686","Justina","F","66","62",128
"2730","Angelia","F","64","64",128
"2846","Harbor","F","61","67",128
"2882","Bellarose","F","60","68",128
"2982","Miliana","F","58","70",128
"2998","Hermione","F","57","71",128
"3341","Annastasia","F","48","80",128
"2432","Jensen","F","75","52",127
"2433","Kenzington","F","75","52",127
"2477","Janai","F","73","54",127
"2583","Jaime","F","69","58",127
"2656","Keyli","F","67","60",127
"2667","Sakura","F","67","60",127
"2694","Tyra","F","66","61",127
"2705","Daelyn","F","65","62",127
"2715","Kalliope","F","65","62",127
"2719","Marilynn","F","65","62",127
"2761","Ahana","F","63","64",127
"2765","Andromeda","F","63","64",127
"2797","Adison","F","62","65",127
"2800","Brynlie","F","62","65",127
"2891","Hanan","F","60","67",127
"2893","Havyn","F","60","67",127
"2971","Eloisa","F","58","69",127
"2986","Ofelia","F","58","69",127
"3057","Francine","F","55","72",127
"3127","Brelynn","F","53","74",127
"3149","Marta","F","53","74",127
"3403","Kelsea","F","47","80",127
"2457","Johannah","F","74","52",126
"2484","Naiya","F","73","53",126
"2608","Zakiya","F","69","57",126
"2612","Alexandrea","F","68","58",126
"2614","Arissa","F","68","58",126
"2644","Brilee","F","67","59",126
"2659","Kymber","F","67","59",126
"2682","Isra","F","66","60",126
"2735","Brilynn","F","64","62",126
"2744","Jaela","F","64","62",126
"2826","Vania","F","62","64",126
"2865","Mirabella","F","61","65",126
"2883","Brailynn","F","60","66",126
"2990","Aariyah","F","57","69",126
"3035","Jaila","F","56","70",126
"3053","Cheryl","F","55","71",126
"3064","Novaleigh","F","55","71",126
"2406","Felicia","F","76","49",125
"2532","Kolbie","F","71","54",125
"2620","Daniyah","F","68","57",125
"2707","Gracey","F","65","60",125
"2772","Denali","F","63","62",125
"2786","Maycie","F","63","62",125
"2818","Lynnlee","F","62","63",125
"2820","Marlen","F","62","63",125
"2839","Cameryn","F","61","64",125
"2894","Henrietta","F","60","65",125
"2921","Azeneth","F","59","66",125
"3168","Aseel","F","52","73",125
"3231","Rozlyn","F","51","74",125
"3290","Clarke","F","49","76",125
"2383","Kalyn","F","77","47",124
"2510","Kim","F","72","52",124
"2515","Meara","F","72","52",124
"2606","Tanner","F","69","55",124
"2624","Ginger","F","68","56",124
"2627","Kylin","F","68","56",124
"2666","Rosanna","F","67","57",124
"2687","Kameryn","F","66","58",124
"2718","Laynee","F","65","59",124
"2720","Neve","F","65","59",124
"2857","Lora","F","61","63",124
"2871","Razan","F","61","63",124
"2896","Iqra","F","60","64",124
"2907","Natali","F","60","64",124
"2908","Navaeh","F","60","64",124
"2910","Tatyana","F","60","64",124
"2430","Jacelynn","F","75","48",123
"2519","Skyy","F","72","51",123
"2577","Emsley","F","69","54",123
"2641","Anvika","F","67","56",123
"2642","Azalia","F","67","56",123
"2669","Yasmina","F","67","56",123
"2729","Analisa","F","64","59",123
"2779","Kensleigh","F","63","60",123
"2792","Sury","F","63","60",123
"2816","Lillia","F","62","61",123
"2832","Aliyanna","F","61","62",123
"2840","Cassia","F","61","62",123
"2856","Lizzie","F","61","62",123
"2922","Brinleigh","F","59","64",123
"2987","Samya","F","58","65",123
"3032","Ebony","F","56","67",123
"3051","Ayat","F","55","68",123
"3147","Maddilynn","F","53","70",123
"3318","Navi","F","49","74",123
"3907","Annora","F","38","85",123
"2456","Jennie","F","74","48",122
"2626","Izabela","F","68","54",122
"2684","Jariah","F","66","56",122
"2743","Iona","F","64","58",122
"2758","Zamiyah","F","64","58",122
"2801","Catarina","F","62","60",122
"2822","Samiah","F","62","60",122
"2869","Railynn","F","61","61",122
"2899","Janylah","F","60","62",122
"2927","Danya","F","59","63",122
"2944","Levi","F","59","63",122
"2995","Callista","F","57","65",122
"3030","Coralynn","F","56","66",122
"3043","Ollie","F","56","66",122
"3091","Effie","F","54","68",122
"3131","Elif","F","53","69",122
"3184","Legend","F","52","70",122
"3880","Maisyn","F","39","83",122
"2427","Emmarose","F","75","46",121
"2536","Maleigha","F","71","50",121
"2590","Kezia","F","69","52",121
"2595","Meah","F","69","52",121
"2632","Payson","F","68","53",121
"2725","Aaliya","F","64","57",121
"2731","Aralynn","F","64","57",121
"2747","Josette","F","64","57",121
"2825","Suzanna","F","62","59",121
"2890","Emorie","F","60","61",121
"2900","Kambrie","F","60","61",121
"2909","Roberta","F","60","61",121
"2933","Esmee","F","59","62",121
"2959","Taylen","F","59","62",121
"2968","Chloee","F","58","63",121
"2996","Ellena","F","57","64",121
"3038","Layken","F","56","65",121
"3274","Mariama","F","50","71",121
"3791","Khari","F","40","81",121
"4080","Elowen","F","36","85",121
"2496","Amyiah","F","72","48",120
"2520","Aleen","F","71","49",120
"2569","Yanely","F","70","50",120
"2629","Maira","F","68","52",120
"2649","Emmery","F","67","53",120
"2712","Jazleen","F","65","55",120
"2714","Kaiden","F","65","55",120
"2757","Scotlyn","F","64","56",120
"2783","Malaika","F","63","57",120
"2790","Rya","F","63","57",120
"2859","Madelyne","F","61","59",120
"2864","Michele","F","61","59",120
"2920","Azari","F","59","61",120
"3664","Jupiter","F","42","78",120
"3715","Jamaya","F","41","79",120
"2495","Abriana","F","72","47",119
"2501","Brinkley","F","72","47",119
"2505","Ily","F","72","47",119
"2523","Ariannah","F","71","48",119
"2677","Delila","F","66","53",119
"2716","Katana","F","65","54",119
"2764","Ameya","F","63","56",119
"2794","Tirzah","F","63","56",119
"2824","Serina","F","62","57",119
"2829","Adaly","F","61","58",119
"2879","Analiah","F","60","59",119
"2903","Lamar","F","60","59",119
"2945","Lili","F","59","60",119
"2993","Averee","F","57","62",119
"3040","Leya","F","56","63",119
"3074","Sparrow","F","55","64",119
"3085","Ayda","F","54","65",119
"2604","Sade","F","69","49",118
"2609","Adia","F","68","50",118
"2665","Reva","F","67","51",118
"2700","Asa","F","65","53",118
"2878","Alaura","F","60","58",118
"3028","Cailee","F","56","62",118
"3081","Alaiya","F","54","64",118
"3116","Adrielle","F","53","65",118
"3177","Ellee","F","52","66",118
"3273","Madina","F","50","68",118
"3589","Bowie","F","43","75",118
"2637","Vanellope","F","68","49",117
"2658","Kristiana","F","67","50",117
"2670","Zaniah","F","67","50",117
"2692","Mattison","F","66","51",117
"2736","Cathy","F","64","53",117
"2751","Lillee","F","64","53",117
"2755","Naomy","F","64","53",117
"2855","Lindy","F","61","56",117
"2931","Emori","F","59","58",117
"2940","Klarissa","F","59","58",117
"2953","Nella","F","59","58",117
"2992","Aulani","F","57","60",117
"3060","Leylah","F","55","62",117
"3194","Symone","F","52","65",117
"2559","Laurie","F","70","46",116
"2572","Amaryllis","F","69","47",116
"2611","Alea","F","68","48",116
"2704","Citlaly","F","65","51",116
"2810","Jaydah","F","62","54",116
"2833","Alize","F","61","55",116
"2838","Caidence","F","61","55",116
"2841","Elanor","F","61","55",116
"2850","Kensi","F","61","55",116
"2861","Maja","F","61","55",116
"2870","Rayan","F","61","55",116
"2872","Safia","F","61","55",116
"2946","Lizette","F","59","57",116
"3007","Nayomi","F","57","59",116
"3114","Zya","F","54","62",116
"3185","Maeleigh","F","52","64",116
"3196","Yahaira","F","52","64",116
"3228","Minerva","F","51","65",116
"3252","Elvira","F","50","66",116
"3358","Katya","F","48","68",116
"2655","Kensie","F","67","48",115
"2698","Annsley","F","65","50",115
"2753","Makyla","F","64","51",115
"2759","Zaylah","F","64","51",115
"2875","Xenia","F","61","54",115
"2876","Yessenia","F","61","54",115
"2929","Delainey","F","59","56",115
"2955","Porter","F","59","56",115
"3058","Izzy","F","55","60",115
"3068","Rosaleigh","F","55","60",115
"3110","Syeda","F","54","61",115
"3112","Zamora","F","54","61",115
"3187","Maryah","F","52","63",115
"2549","Caitlynn","F","70","44",114
"2740","Emree","F","64","50",114
"2749","Kenadie","F","64","50",114
"2781","Liesel","F","63","51",114
"2812","Kiah","F","62","52",114
"2888","Dinah","F","60","54",114
"2895","Hiba","F","60","54",114
"2958","Snow","F","59","55",114
"2984","Nicolle","F","58","56",114
"3015","Tierra","F","57","57",114
"3041","Liora","F","56","58",114
"3045","Simona","F","56","58",114
"3106","Rhiley","F","54","60",114
"3249","Dawsyn","F","50","64",114
"3317","Micaiah","F","49","65",114
"2597","Nadya","F","69","44",113
"2663","Melanny","F","67","46",113
"2724","Ysabella","F","65","48",113
"2750","Lamya","F","64","49",113
"2769","Bryana","F","63","50",113
"2787","Melannie","F","63","50",113
"2814","Kitana","F","62","51",113
"2843","Estefani","F","61","52",113
"2905","Makynzie","F","60","53",113
"2906","Maylani","F","60","53",113
"2928","Daylin","F","59","54",113
"2950","Mckenzi","F","59","54",113
"3020","Allana","F","56","57",113
"3089","Charisma","F","54","59",113
"3096","Jadelyn","F","54","59",113
"3098","Kameron","F","54","59",113
"3145","Lillyanne","F","53","60",113
"3217","Gretta","F","51","62",113
"3240","Ameliah","F","50","63",113
"3268","Leiah","F","50","63",113
"3560","Maven","F","44","69",113
"3750","Advika","F","40","73",113
"2775","Eviana","F","63","49",112
"2830","Alaska","F","61","51",112
"2844","Evelynne","F","61","51",112
"2849","Kami","F","61","51",112
"2904","Leyah","F","60","52",112
"2917","Amairany","F","59","53",112
"2930","Eman","F","59","53",112
"2951","Myracle","F","59","53",112
"2981","Markayla","F","58","54",112
"3010","Semaj","F","57","55",112
"3016","Tristyn","F","57","55",112
"3063","Naira","F","55","57",112
"3070","Sahar","F","55","57",112
"3125","Bentlee","F","53","59",112
"3136","Jameson","F","53","59",112
"3164","Ailey","F","52","60",112
"3263","Kayliana","F","50","62",112
"3343","Avelina","F","48","64",112
"3374","Railyn","F","48","64",112
"2763","Alliyah","F","63","48",111
"2806","Dia","F","62","49",111
"2874","Wednesday","F","61","50",111
"2897","Israel","F","60","51",111
"2936","Jenessa","F","59","52",111
"2994","Caliana","F","57","54",111
"3059","Kambri","F","55","56",111
"3162","Violett","F","53","58",111
"3293","Denim","F","49","62",111
"3338","Amaira","F","48","63",111
"2400","Arantxa","F","76","34",110
"2690","Maliha","F","66","44",110
"2693","Solana","F","66","44",110
"2739","Emmalin","F","64","46",110
"2823","Saraya","F","62","48",110
"2873","Skylyn","F","61","49",110
"2915","Aleida","F","59","51",110
"2957","Rylen","F","59","51",110
"3036","Kaleigha","F","56","54",110
"3130","Delany","F","53","57",110
"3132","Ellisyn","F","53","57",110
"3204","Aysha","F","51","59",110
"3261","Kamia","F","50","60",110
"3264","Kristy","F","50","60",110
"3352","Hala","F","48","62",110
"3379","Tierney","F","48","62",110
"3836","Avionna","F","39","71",110
"2671","Alaynah","F","66","43",109
"2799","Ambar","F","62","47",109
"2880","Anamaria","F","60","49",109
"2923","Brooklin","F","59","50",109
"2934","Fabiana","F","59","50",109
"2937","Kalista","F","59","50",109
"2961","Amila","F","58","51",109
"2967","Cailynn","F","58","51",109
"2973","Ishani","F","58","51",109
"3024","Bernice","F","56","53",109
"3062","Marlei","F","55","54",109
"3077","Tyanna","F","55","54",109
"3093","Everlie","F","54","55",109
"3094","Evey","F","54","55",109
"3121","Amyrah","F","53","56",109
"3152","Meira","F","53","56",109
"3183","Janney","F","52","57",109
"3206","Bradley","F","51","58",109
"3277","Primrose","F","50","59",109
"3394","Fayth","F","47","62",109
"3407","Leigh","F","47","62",109
"3426","Alyssia","F","46","63",109
"3524","Alizabeth","F","44","65",109
"2560","Lexus","F","70","38",108
"2688","Karol","F","66","42",108
"2805","Daniya","F","62","46",108
"2811","Kaylei","F","62","46",108
"2848","Kaidyn","F","61","47",108
"2912","Winry","F","60","48",108
"2947","Lulu","F","59","49",108
"2949","Mayzie","F","59","49",108
"2962","Arleen","F","58","50",108
"2989","Silvana","F","58","50",108
"3019","Alaa","F","56","52",108
"3037","Korbyn","F","56","52",108
"3046","Siobhan","F","56","52",108
"3124","Aryia","F","53","55",108
"3179","Embry","F","52","56",108
"3192","Nada","F","52","56",108
"3221","Kalaya","F","51","57",108
"3267","Leandra","F","50","58",108
"3287","Amie","F","49","59",108
"3399","Joni","F","47","61",108
"3461","Rana","F","46","62",108
"3462","Royce","F","46","62",108
"3464","Seren","F","46","62",108
"2773","Devora","F","63","44",107
"2803","Citlalli","F","62","45",107
"2821","Paetyn","F","62","45",107
"2827","Zahraa","F","62","45",107
"2837","Britany","F","61","46",107
"3001","Jaziyah","F","57","50",107
"3014","Sunshine","F","57","50",107
"3034","Ina","F","56","51",107
"3047","Tenzin","F","56","51",107
"3083","Anessa","F","54","53",107
"3111","Tasneem","F","54","53",107
"3138","Janette","F","53","54",107
"3212","Cloe","F","51","56",107
"3219","Jaide","F","51","56",107
"3303","Jelena","F","49","58",107
"3361","Keylin","F","48","59",107
"3577","Wesley","F","44","63",107
"3747","Zayleigh","F","41","66",107
"2760","Adamari","F","63","43",106
"2802","Chevy","F","62","44",106
"2926","Corrine","F","59","47",106
"2956","Rochelle","F","59","47",106
"3017","Zena","F","57","49",106
"3069","Roxie","F","55","51",106
"3092","Emmanuelle","F","54","52",106
"3095","Farida","F","54","52",106
"3126","Brailyn","F","53","53",106
"3182","Havana","F","52","54",106
"3195","Xitlaly","F","52","54",106
"3202","Amaiya","F","51","55",106
"3218","Jadore","F","51","55",106
"3253","Faiga","F","50","56",106
"3346","Blakeleigh","F","48","58",106
"3397","Indira","F","47","59",106
"3453","Laela","F","46","60",106
"3555","Lilliann","F","44","62",106
"3575","Tammy","F","44","62",106
"3604","Hendrix","F","43","63",106
"3629","Taleen","F","43","63",106
"3652","Dailyn","F","42","64",106
"3924","Gigi","F","38","68",106
"2845","Evy","F","61","44",105
"2887","Delphine","F","60","45",105
"2901","Karrington","F","60","45",105
"2948","Malea","F","59","46",105
"2954","Olga","F","59","46",105
"2974","Jaeda","F","58","47",105
"3005","Lariah","F","57","48",105
"3021","Angelyn","F","56","49",105
"3022","Aralyn","F","56","49",105
"3072","Samirah","F","55","50",105
"3107","Sayuri","F","54","51",105
"3190","Monae","F","52","53",105
"3205","Bayla","F","51","54",105
"3213","Diem","F","51","54",105
"3214","Eastyn","F","51","54",105
"3244","Beautiful","F","50","55",105
"3289","Aylen","F","49","56",105
"3320","Rayah","F","49","56",105
"3441","Hindy","F","46","59",105
"3511","Una","F","45","60",105
"2701","Brileigh","F","65","39",104
"2766","Auden","F","63","41",104
"2768","Ayelen","F","63","41",104
"2807","Elizabella","F","62","42",104
"2819","Macyn","F","62","42",104
"2852","Khole","F","61","43",104
"2970","Divya","F","58","46",104
"2980","Kyliee","F","58","46",104
"3056","Ezri","F","55","49",104
"3076","Trinitee","F","55","49",104
"3157","Rosy","F","53","51",104
"3203","Audri","F","51","53",104
"3208","Calia","F","51","53",104
"3210","Cing","F","51","53",104
"3286","Aleina","F","49","55",104
"3312","Lisbeth","F","49","55",104
"3392","Delani","F","47","57",104
"3412","Nallely","F","47","57",104
"3568","Rainey","F","44","60",104
"3864","James","F","39","65",104
"5436","Aavya","F","24","80",104
"2726","Adamaris","F","64","39",103
"2732","Azlyn","F","64","39",103
"2748","Kailah","F","64","39",103
"2784","Malorie","F","63","40",103
"2902","Kyle","F","60","43",103
"3174","Catalaya","F","52","51",103
"3175","Darianna","F","52","51",103
"3269","Liara","F","50","53",103
"3306","Katherin","F","49","54",103
"3308","Kaycie","F","49","54",103
"3339","Amberlynn","F","48","55",103
"3376","Shylah","F","48","55",103
"3421","Aaryn","F","46","57",103
"3442","Indy","F","46","57",103
"3665","Kaelani","F","42","61",103
"4054","Winona","F","37","66",103
"2770","Cathryn","F","63","39",102
"2860","Madisen","F","61","41",102
"2877","Aiden","F","60","42",102
"2889","Ellah","F","60","42",102
"2935","Jackelyn","F","59","43",102
"2960","Tylee","F","59","43",102
"3029","Ciana","F","56","46",102
"3031","Daiana","F","56","46",102
"3080","Aaniyah","F","54","48",102
"3084","Aubrei","F","54","48",102
"3088","Cayden","F","54","48",102
"3166","Amen","F","52","50",102
"3170","Azra","F","52","50",102
"3171","Brecklyn","F","52","50",102
"3220","Joie","F","51","51",102
"3230","Polly","F","51","51",102
"3266","Landri","F","50","52",102
"3288","Ara","F","49","53",102
"3324","Sofiya","F","49","53",102
"3328","Tatianna","F","49","53",102
"3336","Alizah","F","48","54",102
"3393","Dylann","F","47","55",102
"3395","Gala","F","47","55",102
"3400","Kalayah","F","47","55",102
"3418","Tamera","F","47","55",102
"3448","Karime","F","46","56",102
"3878","Leonie","F","39","63",102
"3908","Aryn","F","38","64",102
"4825","Teigen","F","29","73",102
"2863","Marisela","F","61","40",101
"2939","Kendyll","F","59","42",101
"2964","Becky","F","58","43",101
"3026","Breckyn","F","56","45",101
"3082","Alysha","F","54","47",101
"3120","Amilya","F","53","48",101
"3135","Iyonna","F","53","48",101
"3154","Naliyah","F","53","48",101
"3159","Sora","F","53","48",101
"3173","Candy","F","52","49",101
"3180","Gabriel","F","52","49",101
"3279","Ryah","F","50","51",101
"3337","Alysia","F","48","53",101
"3609","Joleigh","F","43","58",101
"3657","Francisca","F","42","59",101
"3668","Landree","F","42","59",101
"3726","Maris","F","41","60",101
"3761","Bostyn","F","40","61",101
"2728","Alynna","F","64","36",100
"2884","Cedar","F","60","40",100
"2898","Izabell","F","60","40",100
"3055","Esha","F","55","45",100
"3108","Sima","F","54","46",100
"3129","Dayla","F","53","47",100
"3172","Brenley","F","52","48",100
"3197","Zada","F","52","48",100
"3198","Ailee","F","51","49",100
"3223","Leeah","F","51","49",100
"3226","Makiah","F","51","49",100
"3238","Aashi","F","50","50",100
"3332","Vanna","F","49","51",100
"3396","Graycen","F","47","53",100
"3496","Laia","F","45","55",100
"3514","Vesper","F","45","55",100
"3669","Lexa","F","42","58",100
"3745","Zaryah","F","41","59",100
"3804","Maxwell","F","40","60",100
"4109","Nazareth","F","36","64",100
"2703","Chelsie","F","65","34",99
"2881","Arsema","F","60","39",99
"2966","Britta","F","58","41",99
"3011","Shaelynn","F","57","42",99
"3048","Aislin","F","55","44",99
"3097","Jakiyah","F","54","45",99
"3105","Raylyn","F","54","45",99
"3117","Aiva","F","53","46",99
"3153","Monserrath","F","53","46",99
"3163","Ahna","F","52","47",99
"3245","Bryar","F","50","49",99
"3265","Lamiyah","F","50","49",99
"3291","Coralyn","F","49","50",99
"3301","Honey","F","49","50",99
"3335","Aleya","F","48","51",99
"3402","Kateri","F","47","52",99
"3414","Orianna","F","47","52",99
"3430","Aurielle","F","46","53",99
"3454","Maha","F","46","53",99
"3553","Lakelynn","F","44","55",99
"3573","Sirena","F","44","55",99
"3599","Eshaal","F","43","56",99
"3963","Rio","F","38","61",99
"2678","Destiney","F","66","32",98
"2943","Lakynn","F","59","39",98
"2978","Julisa","F","58","40",98
"2988","Sephora","F","58","40",98
"2991","Aliannah","F","57","41",98
"3000","Jalisa","F","57","41",98
"3003","Kaniya","F","57","41",98
"3039","Layton","F","56","42",98
"3066","Pandora","F","55","43",98
"3075","Talitha","F","55","43",98
"3087","Breanne","F","54","44",98
"3109","Soliana","F","54","44",98
"3156","Reema","F","53","45",98
"3178","Ellora","F","52","46",98
"3262","Karsen","F","50","48",98
"3283","Tahiry","F","50","48",98
"3314","Madelin","F","49","49",98
"3353","Hayzel","F","48","50",98
"3368","Madelynne","F","48","50",98
"3390","Carmyn","F","47","51",98
"3408","Leonora","F","47","51",98
"3427","Amoni","F","46","52",98
"3534","Chany","F","44","54",98
"3540","Griselda","F","44","54",98
"3563","Mirabel","F","44","54",98
"3634","Abigael","F","42","56",98
"3675","Mishka","F","42","56",98
"3753","Aleeza","F","40","58",98
"3767","Eimy","F","40","58",98
"3850","Emelie","F","39","59",98
"4003","Ellarose","F","37","61",98
"4057","Aaria","F","36","62",98
"2813","Kimberlee","F","62","35",97
"2862","Makynlee","F","61","36",97
"3027","Brithany","F","56","41",97
"3054","Chole","F","55","42",97
"3118","Allyssa","F","53","44",97
"3160","Tanisha","F","53","44",97
"3167","Analiese","F","52","45",97
"3199","Alaynna","F","51","46",97
"3207","Brailey","F","51","46",97
"3215","Gisela","F","51","46",97
"3234","Sianna","F","51","46",97
"3257","Honesti","F","50","47",97
"3297","Gwenevere","F","49","48",97
"3309","Keisy","F","49","48",97
"3311","Lillianne","F","49","48",97
"3416","Rhoda","F","47","50",97
"3419","Teyana","F","47","50",97
"3433","Carolynn","F","46","51",97
"3463","Ryland","F","46","51",97
"3477","Aziza","F","45","52",97
"3536","Elva","F","44","53",97
"3562","Mei","F","44","53",97
"3564","Nadiya","F","44","53",97
"3571","Scottie","F","44","53",97
"3663","Jayline","F","42","55",97
"3699","Bayley","F","41","56",97
"3728","October","F","41","56",97
"3809","Nikole","F","40","57",97
"2925","Cate","F","59","37",96
"2979","Kalie","F","58","38",96
"3002","Jewels","F","57","39",96
"3042","Mikah","F","56","40",96
"3061","Lisette","F","55","41",96
"3104","Mckynlee","F","54","42",96
"3139","Jayci","F","53","43",96
"3151","Mea","F","53","43",96
"3158","Shanelle","F","53","43",96
"3236","Tyla","F","51","45",96
"3272","Lya","F","50","46",96
"3304","Kaili","F","49","47",96
"3325","Stefanie","F","49","47",96
"3362","Kimberlynn","F","48","48",96
"3369","Mayleigh","F","48","48",96
"3382","Zeynep","F","48","48",96
"3415","Raizel","F","47","49",96
"3445","Jamilah","F","46","50",96
"3501","Myrah","F","45","51",96
"3530","Bronwyn","F","44","52",96
"3610","Joselynn","F","43","53",96
"3632","Zaliyah","F","43","53",96
"3681","Tinlee","F","42","54",96
"3717","Jeslyn","F","41","55",96
"3754","Amberlyn","F","40","56",96
"3775","Jaleesa","F","40","56",96
"4113","Raniya","F","36","60",96
"4213","Zeina","F","35","61",96
"2976","Jaymie","F","58","37",95
"3134","Henlee","F","53","42",95
"3146","Macee","F","53","42",95
"3189","Misty","F","52","43",95
"3191","Mykah","F","52","43",95
"3278","Roya","F","50","45",95
"3281","Serinity","F","50","45",95
"3310","Leeanna","F","49","46",95
"3319","Rahaf","F","49","46",95
"3334","Aisling","F","48","47",95
"3340","Analicia","F","48","47",95
"3365","Luana","F","48","47",95
"3380","Vail","F","48","47",95
"3405","Lariyah","F","47","48",95
"3455","Mai","F","46","49",95
"3465","Stefania","F","46","49",95
"3475","Arwa","F","45","50",95
"3505","Sapphira","F","45","50",95
"3507","Shaylynn","F","45","50",95
"3508","Taegan","F","45","50",95
"3617","Madaline","F","43","52",95
"3897","Yelena","F","39","56",95
"4075","Cambri","F","36","59",95
"2312","Yazaira","F","81","13",94
"2913","Zamira","F","60","34",94
"3073","Sincere","F","55","39",94
"3133","Elyanna","F","53","41",94
"3141","Jorja","F","53","41",94
"3143","Kaleena","F","53","41",94
"3161","Vanesa","F","53","41",94
"3200","Aline","F","51","43",94
"3227","Miamor","F","51","43",94
"3237","Wynn","F","51","43",94
"3247","Caris","F","50","44",94
"3260","Josalyn","F","50","44",94
"3305","Kambria","F","49","45",94
"3360","Kenzlie","F","48","46",94
"3366","Lucca","F","48","46",94
"3377","Siham","F","48","46",94
"3409","Miangel","F","47","47",94
"3425","Adelaida","F","46","48",94
"3484","Everett","F","45","49",94
"3493","Keilyn","F","45","49",94
"3510","Tynlee","F","45","49",94
"3523","Alaysha","F","44","50",94
"3528","Braylie","F","44","50",94
"3690","Addy","F","41","53",94
"3695","Anela","F","41","53",94
"3709","Ellamae","F","41","53",94
"3938","Kelani","F","38","56",94
"3954","Onyx","F","38","56",94
"2924","Brystal","F","59","34",93
"3012","Sicily","F","57","36",93
"3150","Mayleen","F","53","40",93
"3259","Jaziah","F","50","43",93
"3276","Pilar","F","50","43",93
"3322","Sania","F","49","44",93
"3330","Truly","F","49","44",93
"3351","Goldy","F","48","45",93
"3357","Karisma","F","48","45",93
"3388","An","F","47","46",93
"3398","Jaylanie","F","47","46",93
"3417","Sena","F","47","46",93
"3466","Swayze","F","46","47",93
"3468","Victory","F","46","47",93
"3515","Yazmine","F","45","48",93
"3548","Kellie","F","44","49",93
"3576","Vale","F","44","49",93
"3670","Madden","F","42","51",93
"3723","Louella","F","41","52",93
"3731","Queenie","F","41","52",93
"4013","Hollyn","F","37","56",93
"4055","Yatzil","F","37","56",93
"4083","Gretel","F","36","57",93
"4111","Quinley","F","36","57",93
"2914","Ailin","F","59","33",92
"3023","Ashlin","F","56","36",92
"3115","Zyra","F","54","38",92
"3224","Magali","F","51","41",92
"3225","Mahi","F","51","41",92
"3232","Rozlynn","F","51","41",92
"3254","Fannie","F","50","42",92
"3321","Ryker","F","49","43",92
"3355","Jalia","F","48","44",92
"3367","Maddalyn","F","48","44",92
"3381","Zaylie","F","48","44",92
"3411","Monika","F","47","45",92
"3451","Kimani","F","46","46",92
"3550","Keturah","F","44","48",92
"3581","Aeryn","F","43","49",92
"3584","Anari","F","43","49",92
"3643","Aveah","F","42","50",92
"3645","Baleigh","F","42","50",92
"3700","Bianka","F","41","51",92
"3703","Dayra","F","41","51",92
"3716","Jentry","F","41","51",92
"3724","Lyndsey","F","41","51",92
"3769","Eriana","F","40","52",92
"4067","Auri","F","36","56",92
"4397","Anaisha","F","32","60",92
"2851","Khloey","F","61","30",91
"2963","Bay","F","58","33",91
"2985","Oaklie","F","58","33",91
"2997","Emmah","F","57","34",91
"3100","Lenox","F","54","37",91
"3101","Maisey","F","54","37",91
"3103","Marely","F","54","37",91
"3142","Jozie","F","53","38",91
"3155","Raygan","F","53","38",91
"3250","Deena","F","50","41",91
"3258","Janine","F","50","41",91
"3300","Holley","F","49","42",91
"3323","Shalom","F","49","42",91
"3364","Lake","F","48","43",91
"3378","Talayah","F","48","43",91
"3437","Damya","F","46","45",91
"3488","Haneen","F","45","46",91
"3497","Leilanie","F","45","46",91
"3662","Jayana","F","42","49",91
"3710","Emilynn","F","41","50",91
"3794","Leni","F","40","51",91
"3807","Naisha","F","40","51",91
"3947","Michal","F","38","53",91
"4056","Zoelle","F","37","54",91
"3050","Avri","F","55","35",90
"3123","Anushka","F","53","37",90
"3148","Makaylee","F","53","37",90
"3216","Gittel","F","51","39",90
"3241","Atley","F","50","40",90
"3243","Aysia","F","50","40",90
"3345","Azucena","F","48","42",90
"3375","Reegan","F","48","42",90
"3385","Aletheia","F","47","43",90
"3406","Leiana","F","47","43",90
"3491","Kamrynn","F","45","45",90
"3506","Sereniti","F","45","45",90
"3512","Vaeda","F","45","45",90
"3567","Perri","F","44","46",90
"3570","Rosella","F","44","46",90
"3596","Dayna","F","43","47",90
"3602","Harlowe","F","43","47",90
"3624","Raelynne","F","43","47",90
"3639","Aleyza","F","42","48",90
"3687","Zenobia","F","42","48",90
"3691","Alizae","F","41","49",90
"3815","Silver","F","40","50",90
"3886","Olympia","F","39","51",90
"3979","Adora","F","37","53",90
"4071","Blima","F","36","54",90
"4472","Zhuri","F","32","58",90
"8376","Yamila","F","14","76",90
"2969","Deonna","F","58","31",89
"3009","Raylan","F","57","32",89
"3067","Raylen","F","55","34",89
"3086","Brailee","F","54","35",89
"3188","Mathilda","F","52","37",89
"3294","Emmelyn","F","49","40",89
"3295","Ena","F","49","40",89
"3370","Morrigan","F","48","41",89
"3410","Mischa","F","47","42",89
"3476","Aundrea","F","45","44",89
"3486","Gray","F","45","44",89
"3509","Tailynn","F","45","44",89
"3547","Karah","F","44","45",89
"3554","Lenna","F","44","45",89
"3566","Nubia","F","44","45",89
"3613","Kay","F","43","46",89
"3739","Valkyrie","F","41","48",89
"3792","Khloie","F","40","49",89
"3823","Ailany","F","39","50",89
"3918","Debra","F","38","51",89
"3953","Odalys","F","38","51",89
"4070","Blakelynn","F","36","53",89
"3122","Aniyla","F","53","35",88
"3128","Caylin","F","53","35",88
"3137","Janay","F","53","35",88
"3144","Kyli","F","53","35",88
"3181","Grayce","F","52","36",88
"3186","Makaela","F","52","36",88
"3209","Cesia","F","51","37",88
"3229","Paislie","F","51","37",88
"3280","Saray","F","50","38",88
"3282","Starla","F","50","38",88
"3299","Hilda","F","49","39",88
"3326","Suzette","F","49","39",88
"3333","Zyanna","F","49","39",88
"3344","Avrie","F","48","40",88
"3383","Aanvi","F","47","41",88
"3413","Nawal","F","47","41",88
"3495","Khylie","F","45","43",88
"3503","Nithya","F","45","43",88
"3519","Ahri","F","44","44",88
"3529","Breelynn","F","44","44",88
"3583","Amalie","F","43","45",88
"3598","Emari","F","43","45",88
"3763","Cydney","F","40","48",88
"3802","Malin","F","40","48",88
"3821","Zamya","F","40","48",88
"3910","Avika","F","38","50",88
"3981","Alanie","F","37","51",88
"4012","Giavonna","F","37","51",88
"4401","Aris","F","32","56",88
"4404","Arlo","F","32","56",88
"4539","Letti","F","31","57",88
"3140","Jena","F","53","34",87
"3193","Renae","F","52","35",87
"3201","Alysa","F","51","36",87
"3211","Clarity","F","51","36",87
"3349","Evette","F","48","39",87
"3363","Kylei","F","48","39",87
"3389","Caileigh","F","47","40",87
"3489","Jai","F","45","42",87
"3533","Caterina","F","44","43",87
"3558","Maida","F","44","43",87
"3565","Noora","F","44","43",87
"3594","Constanza","F","43","44",87
"3654","Divina","F","42","45",87
"3666","Kahlia","F","42","45",87
"3683","Vianna","F","42","45",87
"3808","Nayely","F","40","47",87
"3842","Daliah","F","39","48",87
"3876","Leighla","F","39","48",87
"3913","Azuri","F","38","49",87
"4058","Addeline","F","36","51",87
"4124","Teagen","F","36","51",87
"4416","Elara","F","32","55",87
"2938","Keisha","F","59","27",86
"2952","Neela","F","59","27",86
"3052","Brantley","F","55","31",86
"3090","Dayani","F","54","32",86
"3119","Amillia","F","53","33",86
"3165","Alexxa","F","52","34",86
"3169","Auburn","F","52","34",86
"3239","Alinah","F","50","36",86
"3251","Dezirae","F","50","36",86
"3271","Liesl","F","50","36",86
"3315","Meila","F","49","37",86
"3424","Addysen","F","46","40",86
"3429","Angelika","F","46","40",86
"3432","Bliss","F","46","40",86
"3439","Graciella","F","46","40",86
"3443","Jacklynn","F","46","40",86
"3543","Janell","F","44","42",86
"3551","Kimberley","F","44","42",86
"3619","Maiah","F","43","43",86
"3648","Camari","F","42","44",86
"3660","Jailah","F","42","44",86
"3686","Zari","F","42","44",86
"3746","Zayah","F","41","45",86
"3759","Avie","F","40","46",86
"3779","Jessalynn","F","40","46",86
"3867","Jenavieve","F","39","47",86
"3885","Noura","F","39","47",86
"3989","Boston","F","37","49",86
"4149","Chassidy","F","35","51",86
"4396","Anabia","F","32","54",86
"4415","Dynasty","F","32","54",86
"3099","Kiyomi","F","54","31",85
"3176","Demetria","F","52","33",85
"3235","Tayah","F","51","34",85
"3404","Lakota","F","47","38",85
"3422","Abbigale","F","46","39",85
"3446","Jamison","F","46","39",85
"3452","Kynley","F","46","39",85
"3485","Golda","F","45","40",85
"3492","Kayle","F","45","40",85
"3502","Nihira","F","45","40",85
"3504","Rubie","F","45","40",85
"3526","Beau","F","44","41",85
"3651","Clarice","F","42","43",85
"3653","Daya","F","42","43",85
"3658","Genessis","F","42","43",85
"3667","Kalila","F","42","43",85
"3672","Malayna","F","42","43",85
"3693","Amore","F","41","44",85
"3803","Marly","F","40","45",85
"3806","Monet","F","40","45",85
"3812","Roma","F","40","45",85
"3855","Fatou","F","39","46",85
"4163","Gianella","F","35","50",85
"4192","Naina","F","35","50",85
"4443","Landon","F","32","53",85
"3004","Kenzy","F","57","27",84
"3256","Hinda","F","50","34",84
"3316","Messiah","F","49","35",84
"3350","Gabby","F","48","36",84
"3384","Adriel","F","47","37",84
"3440","Greyson","F","46","38",84
"3458","Neha","F","46","38",84
"3469","Yanet","F","46","38",84
"3545","Jocelyne","F","44","40",84
"3614","Kymani","F","43","41",84
"3621","Maureen","F","43","41",84
"3627","Shawna","F","43","41",84
"3671","Maeva","F","42","42",84
"3674","Maryanne","F","42","42",84
"3689","Zoha","F","42","42",84
"3692","Amena","F","41","43",84
"3722","Lanae","F","41","43",84
"3732","Rhema","F","41","43",84
"3854","Evyn","F","39","45",84
"3879","Lian","F","39","45",84
"3898","Airabella","F","38","46",84
"3899","Alaiah","F","38","46",84
"3958","Reaghan","F","38","46",84
"4037","Myiah","F","37","47",84
"4171","Jessenia","F","35","49",84
"4598","Caraline","F","30","54",84
"3044","Shakira","F","56","27",83
"3270","Liba","F","50","33",83
"3327","Tamiya","F","49","34",83
"3331","Valarie","F","49","34",83
"3354","Jaedyn","F","48","35",83
"3373","Payslee","F","48","35",83
"3436","Dagny","F","46","37",83
"3472","Alecia","F","45","38",83
"3474","Anyah","F","45","38",83
"3490","Jaylie","F","45","38",83
"3527","Beth","F","44","39",83
"3580","Adelin","F","43","40",83
"3611","Juliett","F","43","40",83
"3615","Kynzie","F","43","40",83
"3620","Maribelle","F","43","40",83
"3661","Jasper","F","42","41",83
"3685","Yohana","F","42","41",83
"3712","Gaby","F","41","42",83
"3740","Vittoria","F","41","42",83
"3764","Cypress","F","40","43",83
"3772","Haylen","F","40","43",83
"3785","Kamara","F","40","43",83
"3795","Leonor","F","40","43",83
"3845","Darya","F","39","44",83
"3852","Erianna","F","39","44",83
"3857","Gracee","F","39","44",83
"3893","Shivani","F","39","44",83
"3956","Rafaela","F","38","45",83
"4011","Evanna","F","37","46",83
"4107","Moxie","F","36","47",83
"4136","Amariyah","F","35","48",83
"4310","Dolores","F","33","50",83
"4863","Cristel","F","28","55",83
"3033","Hilary","F","56","26",82
"3233","Sanjana","F","51","31",82
"3285","Adrina","F","49","33",82
"3401","Kalise","F","47","35",82
"3450","Kendalyn","F","46","36",82
"3513","Venice","F","45","37",82
"3522","Alara","F","44","38",82
"3525","Arlyn","F","44","38",82
"3531","Brynne","F","44","38",82
"3542","Jaicee","F","44","38",82
"3552","Korah","F","44","38",82
"3595","Dariyah","F","43","39",82
"3638","Aicha","F","42","40",82
"3649","Cherry","F","42","40",82
"3679","Sydni","F","42","40",82
"3702","Chloey","F","41","41",82
"3721","Kylan","F","41","41",82
"3742","Xaria","F","41","41",82
"3800","Luiza","F","40","42",82
"3825","Airam","F","39","43",82
"3841","Corrie","F","39","43",82
"3881","Marcia","F","39","43",82
"3889","Reginae","F","39","43",82
"3890","Rosetta","F","39","43",82
"3912","Ayala","F","38","44",82
"3921","Divinity","F","38","44",82
"3951","Neely","F","38","44",82
"4002","Eldana","F","37","45",82
"4007","Emy","F","37","45",82
"4228","Camiyah","F","34","48",82
"4361","Nayelli","F","33","49",82
"4473","Aahana","F","31","51",82
"4618","Eveline","F","30","52",82
"4624","Hudsyn","F","30","52",82
"3292","Corrina","F","49","32",81
"3371","Naiomi","F","48","33",81
"3431","Avagrace","F","46","35",81
"3449","Kaylan","F","46","35",81
"3481","Colby","F","45","36",81
"3483","Eleana","F","45","36",81
"3556","Lundyn","F","44","37",81
"3569","Reeva","F","44","37",81
"3587","Aylani","F","43","38",81
"3590","Braylen","F","43","38",81
"3608","Jodi","F","43","38",81
"3650","Chloie","F","42","39",81
"3676","Mykayla","F","42","39",81
"3680","Terri","F","42","39",81
"3701","Blossom","F","41","40",81
"3727","Mishika","F","41","40",81
"3770","Eulalia","F","40","41",81
"3801","Lyriq","F","40","41",81
"3817","Tamiyah","F","40","41",81
"3828","Amity","F","39","42",81
"3851","Emileigh","F","39","42",81
"3853","Esty","F","39","42",81
"3863","Jalyssa","F","39","42",81
"3871","Keaton","F","39","42",81
"3875","Kyree","F","39","42",81
"3909","Atara","F","38","43",81
"3915","Bralynn","F","38","43",81
"3922","Dorothea","F","38","43",81
"3926","Hennessy","F","38","43",81
"3934","Jizelle","F","38","43",81
"3974","Wisdom","F","38","43",81
"4062","Ainhoa","F","36","45",81
"4322","Harli","F","33","48",81
"4362","Oluwadarasimi","F","33","48",81
"4461","Raeya","F","32","49",81
"4533","Khori","F","31","50",81
"3242","Avari","F","50","30",80
"3313","Maddyson","F","49","31",80
"3329","Tru","F","49","31",80
"3423","Adalene","F","46","34",80
"3459","Pessy","F","46","34",80
"3517","Ziah","F","45","35",80
"3537","Evianna","F","44","36",80
"3559","Manal","F","44","36",80
"3572","Shelly","F","44","36",80
"3603","Heavenlee","F","43","37",80
"3625","Saron","F","43","37",80
"3635","Adalena","F","42","38",80
"3637","Ahlam","F","42","38",80
"3642","Avarose","F","42","38",80
"3694","Andee","F","41","39",80
"3706","Elianah","F","41","39",80
"3729","Oliviah","F","41","39",80
"3755","Angeles","F","40","40",80
"3783","Kacy","F","40","40",80
"3784","Kadyn","F","40","40",80
"3820","Zaara","F","40","40",80
"3874","Kynlie","F","39","41",80
"3884","Nashla","F","39","41",80
"3945","Maddelyn","F","38","42",80
"4000","Dena","F","37","43",80
"4005","Emersen","F","37","43",80
"4010","Evalee","F","37","43",80
"4030","Mallie","F","37","43",80
"4043","Passion","F","37","43",80
"4051","Sonora","F","37","43",80
"4086","Jadelynn","F","36","44",80
"4146","Brynnleigh","F","35","45",80
"4195","Niamh","F","35","45",80
"4285","Zoei","F","34","46",80
"4458","Naylah","F","32","48",80
"4674","Queena","F","30","50",80
"5356","Kahlani","F","25","55",80
"3275","Meryl","F","50","29",79
"3307","Katlyn","F","49","30",79
"3348","Clair","F","48","31",79
"3435","Cree","F","46","33",79
"3444","Jaliah","F","46","33",79
"3460","Ramiyah","F","46","33",79
"3535","Eleyna","F","44","35",79
"3549","Kerrington","F","44","35",79
"3579","Zophia","F","44","35",79
"3585","Arriana","F","43","36",79
"3607","Jaymee","F","43","36",79
"3616","Lumen","F","43","36",79
"3673","Marlyn","F","42","37",79
"3678","Sanya","F","42","37",79
"3789","Keri","F","40","39",79
"3827","Ami","F","39","40",79
"3844","Damia","F","39","40",79
"3856","Fraidy","F","39","40",79
"3870","Kasandra","F","39","40",79
"3927","Ilianna","F","38","41",79
"3930","Janya","F","38","41",79
"3960","Rianna","F","38","41",79
"3976","Zori","F","38","41",79
"4044","Raegen","F","37","42",79
"4052","Tariah","F","37","42",79
"4094","Kamyla","F","36","43",79
"4170","Jemima","F","35","44",79
"4199","Rayla","F","35","44",79
"4203","Sidra","F","35","44",79
"4256","Lynley","F","34","45",79
"4286","Aalia","F","33","46",79
"4505","Emaleigh","F","31","48",79
"4652","Mahira","F","30","49",79
"3255","Fanny","F","50","28",78
"3420","Aaliah","F","46","32",78
"3470","Acadia","F","45","33",78
"3487","Greenlee","F","45","33",78
"3640","Amariana","F","42","36",78
"3644","Azariyah","F","42","36",78
"3719","Kelli","F","41","37",78
"3738","Valentine","F","41","37",78
"3743","Yohanna","F","41","37",78
"3744","Yoselyn","F","41","37",78
"3748","Zuria","F","41","37",78
"3771","Goddess","F","40","38",78
"3777","Jayliana","F","40","38",78
"3816","Skyleigh","F","40","38",78
"3846","Delta","F","39","39",78
"3858","Hadlie","F","39","39",78
"3861","Jailene","F","39","39",78
"3862","Jalani","F","39","39",78
"3936","Kaiah","F","38","40",78
"3942","Lark","F","38","40",78
"4060","Adore","F","36","42",78
"4069","Bayan","F","36","42",78
"4127","Tzipora","F","36","42",78
"4153","Elanie","F","35","43",78
"4181","Kynzleigh","F","35","43",78
"4246","Kapri","F","34","44",78
"4283","Vanya","F","34","44",78
"4307","Chelsy","F","33","45",78
"4325","Imogene","F","33","45",78
"4332","Kamyah","F","33","45",78
"4369","Rogue","F","33","45",78
"4566","Yajaira","F","31","47",78
"4959","Weslyn","F","28","50",78
"3298","Henny","F","49","28",77
"3302","Ivonne","F","49","28",77
"3438","Deisy","F","46","31",77
"3592","Chimamanda","F","43","34",77
"3600","Hadasa","F","43","34",77
"3626","Sayler","F","43","34",77
"3631","Yelitza","F","43","34",77
"3725","Mali","F","41","36",77
"3730","Posey","F","41","36",77
"3773","Henleigh","F","40","37",77
"3799","Livy","F","40","37",77
"3822","Zayra","F","40","37",77
"3830","Arian","F","39","38",77
"3848","Eleen","F","39","38",77
"3904","Amberlee","F","38","39",77
"3933","Jazlene","F","38","39",77
"3957","Raigan","F","38","39",77
"3997","Corinna","F","37","40",77
"4042","Niylah","F","37","40",77
"4065","Alizay","F","36","41",77
"4072","Brady","F","36","41",77
"4097","Kristel","F","36","41",77
"4117","Riyah","F","36","41",77
"4121","Seven","F","36","41",77
"4210","Zaila","F","35","42",77
"4349","Maizey","F","33","44",77
"4370","Rorie","F","33","44",77
"4433","Kaela","F","32","45",77
"4462","Rawan","F","32","45",77
"5752","Max","F","23","54",77
"3386","Alyah","F","47","29",76
"3387","Alyssandra","F","47","29",76
"3456","Makenzy","F","46","30",76
"3467","Tamya","F","46","30",76
"3482","Dallis","F","45","31",76
"3518","Abree","F","44","32",76
"3520","Aine","F","44","32",76
"3544","Jett","F","44","32",76
"3578","Zaynah","F","44","32",76
"3582","Ailynn","F","43","33",76
"3588","Bobbie","F","43","33",76
"3655","Emiko","F","42","34",76
"3656","Emmagrace","F","42","34",76
"3684","Yides","F","42","34",76
"3735","Shanell","F","41","35",76
"3776","Jamileth","F","40","36",76
"3778","Jeanne","F","40","36",76
"3797","Livi","F","40","36",76
"3810","Peri","F","40","36",76
"3833","Arisha","F","39","37",76
"3849","Elianny","F","39","37",76
"3859","Hera","F","39","37",76
"3868","Jewell","F","39","37",76
"3888","Rayanna","F","39","37",76
"3966","Skylie","F","38","38",76
"3982","Aleeya","F","37","39",76
"4078","Eesha","F","36","40",76
"4082","Eugenia","F","36","40",76
"4225","Berkleigh","F","34","42",76
"4274","Riyan","F","34","42",76
"4314","Eleonora","F","33","43",76
"4340","Khushi","F","33","43",76
"4426","Hareem","F","32","44",76
"4427","Inayah","F","32","44",76
"4520","Jodie","F","31","45",76
"4634","Jireh","F","30","46",76
"4745","Everest","F","29","47",76
"4866","Defne","F","28","48",76
"5056","Mayeli","F","27","49",76
"5069","November","F","27","49",76
"3347","Catelyn","F","48","27",75
"3391","Chantal","F","47","28",75
"3434","Christie","F","46","29",75
"3471","Alayiah","F","45","30",75
"3473","Alexys","F","45","30",75
"3557","Maelie","F","44","31",75
"3574","Sunnie","F","44","31",75
"3586","Arrianna","F","43","32",75
"3597","Elsy","F","43","32",75
"3601","Halley","F","43","32",75
"3618","Madysen","F","43","32",75
"3630","Tariyah","F","43","32",75
"3711","Erynn","F","41","34",75
"3720","Kierstyn","F","41","34",75
"3749","Adelie","F","40","35",75
"3814","Shayne","F","40","35",75
"3847","Dottie","F","39","36",75
"3896","Yatziry","F","39","36",75
"3911","Avila","F","38","37",75
"3967","Sophya","F","38","37",75
"3977","Zulema","F","38","37",75
"4045","Reed","F","37","38",75
"4073","Caeli","F","36","39",75
"4092","Kadynce","F","36","39",75
"4114","Remedy","F","36","39",75
"4116","Rhyleigh","F","36","39",75
"4267","Niomi","F","34","41",75
"4298","Averly","F","33","42",75
"4323","Husna","F","33","42",75
"4343","Koraline","F","33","42",75
"4430","Jeimy","F","32","43",75
"4452","Merci","F","32","43",75
"4495","Bryndle","F","31","44",75
"4529","Kassidi","F","31","44",75
"4599","Carlota","F","30","45",75
"4978","Aryiah","F","27","48",75
"5428","Yuritzi","F","25","50",75
"3246","Cailin","F","50","24",74
"3498","Liviana","F","45","29",74
"3541","Haileigh","F","44","30",74
"3612","Kaleia","F","43","31",74
"3641","Arisbeth","F","42","32",74
"3697","Ayelet","F","41","33",74
"3713","Helene","F","41","33",74
"3718","Kaliana","F","41","33",74
"3760","Avleen","F","40","34",74
"3762","Breana","F","40","34",74
"3798","Livie","F","40","34",74
"3813","Salina","F","40","34",74
"3837","Brennan","F","39","35",74
"3887","Ona","F","39","35",74
"3901","Alasia","F","38","36",74
"3919","Dejah","F","38","36",74
"3923","Ellanor","F","38","36",74
"3925","Gissel","F","38","36",74
"3992","Camelia","F","37","37",74
"3993","Carrigan","F","37","37",74
"3998","Delina","F","37","37",74
"4008","Enya","F","37","37",74
"4023","Kenslie","F","37","37",74
"4029","Lilee","F","37","37",74
"4046","Rylinn","F","37","37",74
"4077","Collyns","F","36","38",74
"4090","Joleen","F","36","38",74
"4098","Kriti","F","36","38",74
"4118","Rooney","F","36","38",74
"4155","Elida","F","35","39",74
"4165","Gwendalyn","F","35","39",74
"4196","Novella","F","35","39",74
"4221","Annamaria","F","34","40",74
"4231","Christen","F","34","40",74
"4311","Dua","F","33","41",74
"4392","Ameenah","F","32","42",74
"4402","Arlett","F","32","42",74
"4464","Rosaline","F","32","42",74
"4553","Praise","F","31","43",74
"4640","Kamani","F","30","44",74
"6876","Moana","F","18","56",74
"3342","Augusta","F","48","25",73
"3356","Kareena","F","48","25",73
"3499","Maylen","F","45","28",73
"3521","Alahna","F","44","29",73
"3707","Elienai","F","41","32",73
"3714","Jaelah","F","41","32",73
"3768","Ekaterina","F","40","33",73
"3805","Milliana","F","40","33",73
"3824","Ainsleigh","F","39","34",73
"3877","Lelia","F","39","34",73
"3892","Shekinah","F","39","34",73
"3969","Tali","F","38","35",73
"3975","Zenaida","F","38","35",73
"4025","Khaliah","F","37","36",73
"4027","Kynsleigh","F","37","36",73
"4033","Mercedez","F","37","36",73
"4125","Teaghan","F","36","37",73
"4129","Yareni","F","36","37",73
"4141","Apryl","F","35","38",73
"4175","Karmin","F","35","38",73
"4180","Kolby","F","35","38",73
"4212","Zamaya","F","35","38",73
"4241","Jaidah","F","34","39",73
"4242","Janey","F","34","39",73
"4287","Adalin","F","33","40",73
"4447","Maleyah","F","32","41",73
"4463","Ronnie","F","32","41",73
"4468","Tailyn","F","32","41",73
"4524","Jovanna","F","31","42",73
"4535","Kloey","F","31","42",73
"4538","Leonna","F","31","42",73
"4736","Cherokee","F","29","44",73
"4741","Emberleigh","F","29","44",73
"4910","Leidy","F","28","45",73
"5112","Amaiah","F","26","47",73
"6287","Gracy","F","20","53",73
"3447","Jenni","F","46","26",72
"3546","Jolynn","F","44","28",72
"3646","Bradlee","F","42","30",72
"3741","Whitlee","F","41","31",72
"3756","Anny","F","40","32",72
"3766","December","F","40","32",72
"3787","Kellyn","F","40","32",72
"3788","Kenedi","F","40","32",72
"3790","Keya","F","40","32",72
"3818","Unknown","F","40","32",72
"3829","Analucia","F","39","33",72
"3840","Chrisette","F","39","33",72
"3916","Brenlee","F","38","34",72
"3941","Langley","F","38","34",72
"3952","Nivea","F","38","34",72
"3965","Sarenity","F","38","34",72
"4036","Myasia","F","37","35",72
"4040","Nidhi","F","37","35",72
"4053","Tory","F","37","35",72
"4063","Alany","F","36","36",72
"4074","Calina","F","36","36",72
"4108","Muna","F","36","36",72
"4128","Vaishnavi","F","36","36",72
"4143","Auriella","F","35","37",72
"4147","Calie","F","35","37",72
"4169","Jace","F","35","37",72
"4188","Mahalia","F","35","37",72
"4202","Samari","F","35","37",72
"4214","Zemirah","F","35","37",72
"4215","Zoi","F","35","37",72
"4218","Aili","F","34","38",72
"4236","Evamarie","F","34","38",72
"4240","Ishika","F","34","38",72
"4263","Marah","F","34","38",72
"4269","Nohemi","F","34","38",72
"4351","Mariangel","F","33","39",72
"4353","Mazzy","F","33","39",72
"4372","Rylea","F","33","39",72
"4550","Nyra","F","31","41",72
"4621","Franchesca","F","30","42",72
"4633","Jermani","F","30","42",72
"4659","Maysa","F","30","42",72
"4715","Alinna","F","29","43",72
"4743","Emiyah","F","29","43",72
"4798","Masyn","F","29","43",72
"5330","Frieda","F","25","47",72
"3538","Graci","F","44","27",71
"3591","Cami","F","43","28",71
"3605","Jalyn","F","43","28",71
"3623","Nara","F","43","28",71
"3677","Portia","F","42","29",71
"3751","Aiya","F","40","31",71
"3903","Alesia","F","38","33",71
"3906","Annah","F","38","33",71
"3920","Dilynn","F","38","33",71
"3928","Jaclynn","F","38","33",71
"3944","Lucile","F","38","33",71
"3995","Chrissy","F","37","34",71
"4021","Keeva","F","37","34",71
"4085","Ilona","F","36","35",71
"4093","Kaelin","F","36","35",71
"4130","Zahira","F","36","35",71
"4150","Daelynn","F","35","36",71
"4156","Elizah","F","35","36",71
"4253","Layal","F","34","37",71
"4268","Nitya","F","34","37",71
"4359","Najma","F","33","38",71
"4374","Saria","F","33","38",71
"4412","Ciera","F","32","39",71
"4442","Lanaya","F","32","39",71
"4448","Marcy","F","32","39",71
"4542","Logann","F","31","40",71
"4559","Shifra","F","31","40",71
"4610","Dolly","F","30","41",71
"4615","Emmalina","F","30","41",71
"4689","Svea","F","30","41",71
"5180","Julian","F","26","45",71
"5200","Kristian","F","26","45",71
"5224","Meena","F","26","45",71
"5296","Bea","F","25","46",71
"5334","Graceyn","F","25","46",71
"3457","Mayrin","F","46","24",70
"3478","Breasia","F","45","25",70
"3628","Srinika","F","43","27",70
"3636","Adisyn","F","42","28",70
"3682","Trista","F","42","28",70
"3733","Rhylie","F","41","29",70
"3734","Saleen","F","41","29",70
"3737","Ursula","F","41","29",70
"3780","Jesslynn","F","40","30",70
"3786","Kelcie","F","40","30",70
"3838","Caleah","F","39","31",70
"3860","Huntley","F","39","31",70
"3866","Jayanna","F","39","31",70
"3902","Alesha","F","38","32",70
"3929","Jacy","F","38","32",70
"3949","Myriam","F","38","32",70
"3970","Tauriel","F","38","32",70
"3980","Akeelah","F","37","33",70
"3988","Avi","F","37","33",70
"4009","Esabella","F","37","33",70
"4047","Saja","F","37","33",70
"4106","Michael","F","36","34",70
"4142","Athalia","F","35","35",70
"4176","Kennedie","F","35","35",70
"4182","Lamia","F","35","35",70
"4197","Ora","F","35","35",70
"4223","Aubre","F","34","36",70
"4258","Mackenzi","F","34","36",70
"4265","Nalia","F","34","36",70
"4278","Sheridan","F","34","36",70
"4309","Danyla","F","33","37",70
"4312","Eira","F","33","37",70
"4344","Kyleah","F","33","37",70
"4421","Essie","F","32","38",70
"4465","Sameera","F","32","38",70
"4526","Kaedence","F","31","39",70
"4555","Romi","F","31","39",70
"4597","Braylyn","F","30","40",70
"4649","Leighanna","F","30","40",70
"4651","Lujain","F","30","40",70
"4682","Scotland","F","30","40",70
"4873","Evee","F","28","42",70
"4933","Raena","F","28","42",70
"4969","Addisen","F","27","43",70
"5329","Fay","F","25","45",70
"5660","Avaline","F","23","47",70
"6654","Serayah","F","19","51",70
"3532","Cambry","F","44","25",69
"3593","Codi","F","43","26",69
"3633","Aaminah","F","42","27",69
"3704","Dhriti","F","41","28",69
"3708","Eliya","F","41","28",69
"3736","Suhani","F","41","28",69
"3793","Krislyn","F","40","29",69
"3869","Kaely","F","39","30",69
"3905","Anabell","F","38","31",69
"3939","Kimaya","F","38","31",69
"3972","True","F","38","31",69
"3994","Chizaram","F","37","32",69
"4018","Jeannette","F","37","32",69
"4026","Kree","F","37","32",69
"4031","Mela","F","37","32",69
"4048","Salwa","F","37","32",69
"4076","Chantelle","F","36","33",69
"4133","Aela","F","35","34",69
"4137","Amellia","F","35","34",69
"4189","Maryama","F","35","34",69
"4193","Naomie","F","35","34",69
"4235","Envy","F","34","35",69
"4250","Kodie","F","34","35",69
"4272","Reid","F","34","35",69
"4284","Vega","F","34","35",69
"4350","Marcelina","F","33","36",69
"4373","Saori","F","33","36",69
"4480","Aivah","F","31","38",69
"4501","Daila","F","31","38",69
"4521","Johnnie","F","31","38",69
"4527","Kaliya","F","31","38",69
"4544","Maleny","F","31","38",69
"4612","Elleanor","F","30","39",69
"4647","Lainee","F","30","39",69
"4666","Naydelin","F","30","39",69
"4671","Paxtyn","F","30","39",69
"4722","Aniela","F","29","40",69
"4730","Azura","F","29","40",69
"4788","Lennix","F","29","40",69
"4847","Ariany","F","28","41",69
"4895","Katalyna","F","28","41",69
"5173","Ishanvi","F","26","43",69
"5332","Galilee","F","25","44",69
"5717","Jensyn","F","23","46",69
"3479","Brihanna","F","45","23",68
"3561","Mayson","F","44","24",68
"3696","Aster","F","41","27",68
"3757","Ashlynne","F","40","28",68
"3774","Jailee","F","40","28",68
"3839","Caylie","F","39","29",68
"3865","Jaquelyn","F","39","29",68
"3882","Matilyn","F","39","29",68
"3948","Mikaila","F","38","30",68
"3973","Tziporah","F","38","30",68
"4004","Ellyanna","F","37","31",68
"4039","Nico","F","37","31",68
"4059","Adhya","F","36","32",68
"4066","Amour","F","36","32",68
"4157","Elleigh","F","35","33",68
"4164","Gisella","F","35","33",68
"4172","Jessy","F","35","33",68
"4190","Maybelle","F","35","33",68
"4201","Ryen","F","35","33",68
"4234","Ellieanna","F","34","34",68
"4245","Kamea","F","34","34",68
"4248","Keona","F","34","34",68
"4297","Avalina","F","33","35",68
"4316","Embree","F","33","35",68
"4319","Gweneth","F","33","35",68
"4379","Shanti","F","33","35",68
"4383","Sydnie","F","33","35",68
"4407","Azaleah","F","32","36",68
"4508","Evana","F","31","37",68
"4528","Karyme","F","31","37",68
"4546","Mikenzie","F","31","37",68
"4665","Natalyn","F","30","38",68
"4704","Zaiya","F","30","38",68
"4766","Kady","F","29","39",68
"4776","Khyla","F","29","39",68
"4831","Zyon","F","29","39",68
"5248","Rowynn","F","26","42",68
"5283","Arbor","F","25","43",68
"5388","Mirielle","F","25","43",68
"5626","Weslynn","F","24","44",68
"5739","Lennyn","F","23","45",68
"5749","Masa","F","23","45",68
"3752","Akasha","F","40","27",67
"3781","Johnna","F","40","27",67
"3811","Renesmae","F","40","27",67
"3826","Alethea","F","39","28",67
"3831","Arianah","F","39","28",67
"3872","Kenza","F","39","28",67
"3895","Taylyn","F","39","28",67
"3940","Krislynn","F","38","29",67
"3968","Sunni","F","38","29",67
"3971","Tea","F","38","29",67
"3985","Anuhea","F","37","30",67
"3996","Clio","F","37","30",67
"4001","Devina","F","37","30",67
"4017","Jaquelin","F","37","30",67
"4020","Joely","F","37","30",67
"4024","Keyonna","F","37","30",67
"4084","Hania","F","36","31",67
"4087","Jaiya","F","36","31",67
"4089","Jill","F","36","31",67
"4100","Lilyrose","F","36","31",67
"4119","Sarayu","F","36","31",67
"4122","Shelbie","F","36","31",67
"4123","Siana","F","36","31",67
"4159","Elvia","F","35","32",67
"4204","Solange","F","35","32",67
"4209","Yetzali","F","35","32",67
"4220","Amelya","F","34","33",67
"4252","Lareen","F","34","33",67
"4290","Aleana","F","33","34",67
"4299","Avielle","F","33","34",67
"4318","Graysen","F","33","34",67
"4368","Rivkah","F","33","34",67
"4420","Esma","F","32","35",67
"4440","Laelah","F","32","35",67
"4469","Windsor","F","32","35",67
"4491","Bradleigh","F","31","36",67
"4509","Ezrah","F","31","36",67
"4785","Lanna","F","29","38",67
"4916","Lucina","F","28","39",67
"4921","Michaella","F","28","39",67
"4922","Minha","F","28","39",67
"5073","Rafaella","F","27","40",67
"5093","Taliya","F","27","40",67
"5409","Ryla","F","25","42",67
"3500","Micayla","F","45","21",66
"3606","Jaylinn","F","43","23",66
"3647","Bridgett","F","42","24",66
"3796","Lilla","F","40","26",66
"3819","Yuridia","F","40","26",66
"3883","Melodi","F","39","27",66
"3964","Roslynn","F","38","28",66
"3990","Braleigh","F","37","29",66
"4032","Melony","F","37","29",66
"4035","Munira","F","37","29",66
"4079","Elisia","F","36","30",66
"4105","Meher","F","36","30",66
"4139","Anai","F","35","31",66
"4154","Elicia","F","35","31",66
"4186","Maddalena","F","35","31",66
"4243","Jayonna","F","34","32",66
"4271","Raygen","F","34","32",66
"4308","China","F","33","33",66
"4331","Jourdyn","F","33","33",66
"4336","Kayanna","F","33","33",66
"4345","Liliane","F","33","33",66
"4435","Kalei","F","32","34",66
"4444","Leliana","F","32","34",66
"4449","Mariafernanda","F","32","34",66
"4451","Meklit","F","32","34",66
"4457","Nataliya","F","32","34",66
"4476","Adaya","F","31","35",66
"4503","Deema","F","31","35",66
"4516","Janel","F","31","35",66
"4560","Solara","F","31","35",66
"4619","Favour","F","30","36",66
"4663","Miri","F","30","36",66
"4670","Pari","F","30","36",66
"4680","Samyra","F","30","36",66
"4731","Braeleigh","F","29","37",66
"4737","Clarisa","F","29","37",66
"4753","Haizley","F","29","37",66
"4832","Adali","F","28","38",66
"4867","Demiyah","F","28","38",66
"4870","Eliette","F","28","38",66
"4979","Atalia","F","27","39",66
"4989","Brayla","F","27","39",66
"5047","Madisson","F","27","39",66
"5049","Mahnoor","F","27","39",66
"5133","Brianny","F","26","40",66
"5138","Charolette","F","26","40",66
"5267","Tyasia","F","26","40",66
"5381","Maleena","F","25","41",66
"5447","Aira","F","24","42",66
"5496","Eevee","F","24","42",66
"5568","Lynden","F","24","42",66
"5801","Zemira","F","23","43",66
"7724","Hoorain","F","15","51",66
"3428","Anamarie","F","46","19",65
"3659","Jacquelin","F","42","23",65
"3698","Azaliah","F","41","24",65
"3765","Damiya","F","40","25",65
"3843","Dalyla","F","39","26",65
"3891","Senna","F","39","26",65
"3894","Taelor","F","39","26",65
"3943","Lavina","F","38","27",65
"3959","Riana","F","38","27",65
"3986","Asmaa","F","37","28",65
"4019","Jetta","F","37","28",65
"4034","Mihika","F","37","28",65
"4081","Eriel","F","36","29",65
"4099","Lilianne","F","36","29",65
"4115","Rhianna","F","36","29",65
"4158","Ellowyn","F","35","30",65
"4174","Kamden","F","35","30",65
"4198","Phaedra","F","35","30",65
"4205","Somaya","F","35","30",65
"4216","Zury","F","35","30",65
"4247","Kaylea","F","34","31",65
"4255","Lynda","F","34","31",65
"4270","Phoenyx","F","34","31",65
"4280","Soren","F","34","31",65
"4301","Bethanie","F","33","32",65
"4376","Seerat","F","33","32",65
"4377","Selin","F","33","32",65
"4384","Taylar","F","33","32",65
"4399","Annamae","F","32","33",65
"4413","Daisha","F","32","33",65
"4422","Falyn","F","32","33",65
"4438","Kiarra","F","32","33",65
"4439","Kiran","F","32","33",65
"4466","Seneca","F","32","33",65
"4474","Aashna","F","31","34",65
"4478","Ahtziri","F","31","34",65
"4523","Journii","F","31","34",65
"4584","Anniyah","F","30","35",65
"4645","Keanna","F","30","35",65
"4667","Nura","F","30","35",65
"4733","Bushra","F","29","36",65
"4758","Jamyah","F","29","36",65
"4797","Maribella","F","29","36",65
"4801","Mckinleigh","F","29","36",65
"4805","Nami","F","29","36",65
"4817","Scarleth","F","29","36",65
"4868","Dillon","F","28","37",65
"4972","Akari","F","27","38",65
"5035","Kristal","F","27","38",65
"5062","Mirna","F","27","38",65
"5162","Georgie","F","26","39",65
"5243","Raiden","F","26","39",65
"5275","Allena","F","25","40",65
"5324","Erielle","F","25","40",65
"5412","Seraphine","F","25","40",65
"5483","Chantel","F","24","41",65
"3688","Zissy","F","42","22",64
"3705","Drea","F","41","23",64
"3758","Aviah","F","40","24",64
"3834","Arizbeth","F","39","25",64
"3946","Mckinnley","F","38","26",64
"3962","Rima","F","38","26",64
"4041","Nisa","F","37","27",64
"4068","Avaree","F","36","28",64
"4120","Scottlyn","F","36","28",64
"4131","Aarushi","F","35","29",64
"4160","Emri","F","35","29",64
"4208","Veera","F","35","29",64
"4244","Jiana","F","34","30",64
"4277","Sammie","F","34","30",64
"4281","Stormi","F","34","30",64
"4294","Amera","F","33","31",64
"4304","Brylynn","F","33","31",64
"4329","Jesenia","F","33","31",64
"4347","Lynleigh","F","33","31",64
"4389","Aleiah","F","32","32",64
"4512","Haydee","F","31","33",64
"4594","Bertha","F","30","34",64
"4604","Clarabelle","F","30","34",64
"4668","Odelia","F","30","34",64
"4708","Zyonna","F","30","34",64
"4778","Kollins","F","29","35",64
"4790","Lou","F","29","35",64
"4808","Paradise","F","29","35",64
"4826","Tinleigh","F","29","35",64
"4860","Cornelia","F","28","36",64
"4889","Josilyn","F","28","36",64
"4915","Lovina","F","28","36",64
"4932","Raeghan","F","28","36",64
"4974","Alida","F","27","37",64
"5050","Makeda","F","27","37",64
"5148","Ellory","F","26","38",64
"5184","Kaori","F","26","38",64
"5205","Lucienne","F","26","38",64
"5425","Wynne","F","25","39",64
"5463","Aradhya","F","24","40",64
"5501","Elize","F","24","40",64
"5600","Nyssa","F","24","40",64
"6472","Bexlee","F","19","45",64
"3622","Myia","F","43","20",63
"3900","Alainah","F","38","25",63
"3914","Bentleigh","F","38","25",63
"3961","Ricki","F","38","25",63
"3983","Alix","F","37","26",63
"4050","Soha","F","37","26",63
"4096","Kinzleigh","F","36","27",63
"4102","Lorna","F","36","27",63
"4173","Junia","F","35","28",63
"4187","Maebry","F","35","28",63
"4260","Mailani","F","34","29",63
"4261","Mailyn","F","34","29",63
"4276","Sakina","F","34","29",63
"4317","Everlyn","F","33","30",63
"4408","Betsaida","F","32","31",63
"4418","Emelina","F","32","31",63
"4431","Jori","F","32","31",63
"4450","Maryanna","F","32","31",63
"4460","Oumou","F","32","31",63
"4479","Aishah","F","31","32",63
"4494","Brionna","F","31","32",63
"4510","Falynn","F","31","32",63
"4565","Theadora","F","31","32",63
"4575","Amairani","F","30","33",63
"4586","Atarah","F","30","33",63
"4644","Kayci","F","30","33",63
"4655","Maleia","F","30","33",63
"4678","Rinoa","F","30","33",63
"4754","Heba","F","29","34",63
"4764","Joshlynn","F","29","34",63
"4792","Maahi","F","29","34",63
"4802","Medha","F","29","34",63
"4871","Emmelia","F","28","35",63
"4886","Jaleigh","F","28","35",63
"4904","Klynn","F","28","35",63
"4908","Layana","F","28","35",63
"4962","Yumi","F","28","35",63
"4968","Aayla","F","27","36",63
"4976","Amyia","F","27","36",63
"4993","Bryelle","F","27","36",63
"5331","Fynlee","F","25","38",63
"5423","Verna","F","25","38",63
"5838","Avacyn","F","22","41",63
"5928","Lilou","F","22","41",63
"3480","Chyanne","F","45","17",62
"3782","Jozlyn","F","40","22",62
"3978","Aamira","F","37","25",62
"3984","Ammy","F","37","25",62
"4015","Jacee","F","37","25",62
"4138","Amyla","F","35","27",62
"4167","Henna","F","35","27",62
"4226","Blessyn","F","34","28",62
"4273","Riah","F","34","28",62
"4305","Cattaleya","F","33","29",62
"4330","Jolina","F","33","29",62
"4354","Meela","F","33","29",62
"4357","Minna","F","33","29",62
"4409","Brooks","F","32","30",62
"4534","Kinslie","F","31","31",62
"4547","Miral","F","31","31",62
"4548","Mirella","F","31","31",62
"4577","Amarachi","F","30","32",62
"4582","Anh","F","30","32",62
"4585","Asya","F","30","32",62
"4595","Betsabe","F","30","32",62
"4631","Jasiah","F","30","32",62
"4635","Joscelyn","F","30","32",62
"4642","Katniss","F","30","32",62
"4657","Marygrace","F","30","32",62
"4679","Saisha","F","30","32",62
"4683","Shanvi","F","30","32",62
"4686","Shianne","F","30","32",62
"4734","Callan","F","29","33",62
"4755","Jaleyah","F","29","33",62
"4768","Kalleigh","F","29","33",62
"4769","Kamri","F","29","33",62
"4835","Akshaya","F","28","34",62
"4874","Faiza","F","28","34",62
"4876","Freja","F","28","34",62
"4884","Jaelle","F","28","34",62
"4954","Skylan","F","28","34",62
"4971","Aishani","F","27","35",62
"4975","Amoura","F","27","35",62
"5000","Cinthia","F","27","35",62
"5072","Radha","F","27","35",62
"5074","Railey","F","27","35",62
"5077","Remie","F","27","35",62
"5080","Rue","F","27","35",62
"5129","Avelynn","F","26","36",62
"5163","Gertrude","F","26","36",62
"5286","Arwyn","F","25","37",62
"5377","Lyvia","F","25","37",62
"5442","Adi","F","24","38",62
"5689","Eliyanah","F","23","39",62
"5776","Rylann","F","23","39",62
"6215","Aiyla","F","20","42",62
"6592","Mannat","F","19","43",62
"3931","Jaretzy","F","38","23",61
"3937","Katalaya","F","38","23",61
"4101","Lissette","F","36","25",61
"4103","Mailen","F","36","25",61
"4110","Nevaeha","F","36","25",61
"4134","Alanni","F","35","26",61
"4144","Azure","F","35","26",61
"4183","Leasia","F","35","26",61
"4206","Sumayyah","F","35","26",61
"4224","Barbie","F","34","27",61
"4282","Tylah","F","34","27",61
"4302","Brenleigh","F","33","28",61
"4346","Luka","F","33","28",61
"4360","Nandini","F","33","28",61
"4365","Raylene","F","33","28",61
"4382","Sofi","F","33","28",61
"4387","Yessica","F","33","28",61
"4406","Autum","F","32","29",61
"4453","Mesa","F","32","29",61
"4470","Zalayah","F","32","29",61
"4488","Annalicia","F","31","30",61
"4502","Dalylah","F","31","30",61
"4514","Irena","F","31","30",61
"4540","Livvy","F","31","30",61
"4541","Locklyn","F","31","30",61
"4623","Harmonii","F","30","31",61
"4637","Kaeli","F","30","31",61
"4656","Mariska","F","30","31",61
"4677","Rebeka","F","30","31",61
"4690","Syriah","F","30","31",61
"4735","Chance","F","29","32",61
"4746","Faithlynn","F","29","32",61
"4772","Kayloni","F","29","32",61
"4809","Phebe","F","29","32",61
"4813","Safiyah","F","29","32",61
"4824","Talyn","F","29","32",61
"5013","Gionna","F","27","34",61
"5029","Jo","F","27","34",61
"5039","Laurynn","F","27","34",61
"5082","Saba","F","27","34",61
"5084","Safaa","F","27","34",61
"5249","Ryanna","F","26","35",61
"5327","Fanta","F","25","36",61
"5398","Nona","F","25","36",61
"5466","Aurie","F","24","37",61
"5531","Jazlin","F","24","37",61
"5572","Mahayla","F","24","37",61
"5860","Dezire","F","22","39",61
"3832","Arieanna","F","39","21",60
"3950","Naevia","F","38","22",60
"3955","Raelin","F","38","22",60
"3987","Averey","F","37","23",60
"3999","Dempsey","F","37","23",60
"4006","Emilly","F","37","23",60
"4016","Jakiya","F","37","23",60
"4022","Keisi","F","37","23",60
"4028","Lacee","F","37","23",60
"4064","Alauna","F","36","24",60
"4126","Trina","F","36","24",60
"4140","Andy","F","35","25",60
"4191","Morghan","F","35","25",60
"4238","Ilene","F","34","26",60
"4321","Harlan","F","33","27",60
"4367","Riona","F","33","27",60
"4388","Adelene","F","32","28",60
"4437","Kamry","F","32","28",60
"4445","Loryn","F","32","28",60
"4456","Molli","F","32","28",60
"4481","Alicen","F","31","29",60
"4486","Angeli","F","31","29",60
"4489","Antonina","F","31","29",60
"4492","Brienne","F","31","29",60
"4511","Genevie","F","31","29",60
"4518","Jemimah","F","31","29",60
"4536","Koral","F","31","29",60
"4558","Shai","F","31","29",60
"4628","Jamaria","F","30","30",60
"4654","Makenlee","F","30","30",60
"4664","Nakayla","F","30","30",60
"4669","Orla","F","30","30",60
"4693","Taylah","F","30","30",60
"4697","Tymber","F","30","30",60
"4727","Aryan","F","29","31",60
"4795","Maram","F","29","31",60
"4828","Yui","F","29","31",60
"4836","Alexah","F","28","32",60
"4888","Jewelz","F","28","32",60
"4893","Kansas","F","28","32",60
"4901","Kilynn","F","28","32",60
"4925","Neema","F","28","32",60
"4963","Zahava","F","28","32",60
"5006","Eli","F","27","33",60
"5014","Glenda","F","27","33",60
"5054","Marietta","F","27","33",60
"5089","Serah","F","27","33",60
"5090","Shia","F","27","33",60
"5104","Zoriah","F","27","33",60
"5152","Era","F","26","34",60
"5222","Mckynzie","F","26","34",60
"5258","Sunday","F","26","34",60
"5273","Alaylah","F","25","35",60
"5290","Avyana","F","25","35",60
"5294","Basya","F","25","35",60
"5706","Ianna","F","23","37",60
"6003","Wilder","F","22","38",60
"3873","Kyndell","F","39","20",59
"3932","Jax","F","38","21",59
"3935","Joyanna","F","38","21",59
"4135","Alenna","F","35","24",59
"4162","Georgette","F","35","24",59
"4227","Braya","F","34","25",59
"4230","Carsen","F","34","25",59
"4237","Haily","F","34","25",59
"4254","Leilana","F","34","25",59
"4288","Ajah","F","33","26",59
"4289","Akemi","F","33","26",59
"4333","Karaline","F","33","26",59
"4364","Quetzalli","F","33","26",59
"4371","Rosslyn","F","33","26",59
"4398","Andraya","F","32","27",59
"4423","Francheska","F","32","27",59
"4432","Juna","F","32","27",59
"4500","Daijah","F","31","28",59
"4522","Joslin","F","31","28",59
"4563","Talynn","F","31","28",59
"4570","Adeleine","F","30","29",59
"4573","Aloni","F","30","29",59
"4581","Angelita","F","30","29",59
"4596","Blimy","F","30","29",59
"4627","Jadalynn","F","30","29",59
"4648","Lakshmi","F","30","29",59
"4660","Meliah","F","30","29",59
"4661","Melonie","F","30","29",59
"4691","Talaya","F","30","29",59
"4695","Tula","F","30","29",59
"4696","Tylar","F","30","29",59
"4703","Yashvi","F","30","29",59
"4706","Zeinab","F","30","29",59
"4707","Zionna","F","30","29",59
"4716","Alliana","F","29","30",59
"4789","Lindley","F","29","30",59
"4807","Niara","F","29","30",59
"4858","Braxton","F","28","31",59
"4902","Kirby","F","28","31",59
"4903","Kit","F","28","31",59
"4945","Samar","F","28","31",59
"5018","Hallee","F","27","32",59
"5088","Saniah","F","27","32",59
"5095","Thelma","F","27","32",59
"5124","Atziri","F","26","33",59
"5147","Ellasyn","F","26","33",59
"5197","Keyana","F","26","33",59
"5236","Nissi","F","26","33",59
"5328","Fatuma","F","25","34",59
"5340","Indi","F","25","34",59
"5342","Ivyanna","F","25","34",59
"5372","Laykin","F","25","34",59
"5384","Maryan","F","25","34",59
"5387","Milagro","F","25","34",59
"5404","Rida","F","25","34",59
"5621","Tyleah","F","24","35",59
"5629","Zaelynn","F","24","35",59
"5631","Zamiya","F","24","35",59
"5741","Lyza","F","23","36",59
"5881","Idalia","F","22","37",59
"5952","Mylie","F","22","37",59
"5997","Tennyson","F","22","37",59
"5999","Tinslee","F","22","37",59
"6240","Arleigh","F","20","39",59
"6689","Addaline","F","18","41",59
"7508","Sarayah","F","16","43",59
"4088","Jessia","F","36","22",58
"4148","Carlin","F","35","23",58
"4177","Khaliya","F","35","23",58
"4184","Lexis","F","35","23",58
"4222","Anwita","F","34","24",58
"4262","Makennah","F","34","24",58
"4264","Miliani","F","34","24",58
"4275","Saina","F","34","24",58
"4293","Amaree","F","33","25",58
"4303","Britain","F","33","25",58
"4320","Halie","F","33","25",58
"4334","Karsynn","F","33","25",58
"4338","Kenlie","F","33","25",58
"4341","Kiarah","F","33","25",58
"4356","Mikenna","F","33","25",58
"4385","Topanga","F","33","25",58
"4393","Amilah","F","32","26",58
"4428","Jania","F","32","26",58
"4497","Carlyn","F","31","27",58
"4515","Jaimee","F","31","27",58
"4532","Keylee","F","31","27",58
"4543","Loghan","F","31","27",58
"4557","Samyah","F","31","27",58
"4571","Aeva","F","30","28",58
"4614","Ellieana","F","30","28",58
"4636","Judah","F","30","28",58
"4638","Kala","F","30","28",58
"4639","Kaleesi","F","30","28",58
"4662","Minka","F","30","28",58
"4701","Viviane","F","30","28",58
"4713","Aishwarya","F","29","29",58
"4794","Magdalen","F","29","29",58
"4799","Matilde","F","29","29",58
"4848","Ariza","F","28","30",58
"4882","Izzabelle","F","28","30",58
"4887","Jazel","F","28","30",58
"4905","Kynslie","F","28","30",58
"4937","Rayann","F","28","30",58
"4942","Rozalyn","F","28","30",58
"4998","Celestine","F","27","31",58
"5009","Ellinor","F","27","31",58
"5020","Hayat","F","27","31",58
"5024","Jakira","F","27","31",58
"5066","Nalayah","F","27","31",58
"5106","Aariah","F","26","32",58
"5145","Dyani","F","26","32",58
"5153","Evelyne","F","26","32",58
"5301","Cai","F","25","33",58
"5318","Eliyana","F","25","33",58
"5336","Gwendolynn","F","25","33",58
"5498","Elayne","F","24","34",58
"5630","Zailee","F","24","34",58
"5680","Darlyn","F","23","35",58
"6209","Aasiyah","F","20","38",58
"6216","Akilah","F","20","38",58
"10296","Lady","F","10","48",58
"4038","Nabiha","F","37","20",57
"4049","Shana","F","37","20",57
"4091","Josalynn","F","36","21",57
"4104","Manasvi","F","36","21",57
"4194","Natalynn","F","35","22",57
"4200","Rhian","F","35","22",57
"4239","Isamar","F","34","23",57
"4257","Mackayla","F","34","23",57
"4295","Anvitha","F","33","24",57
"4306","Chavy","F","33","24",57
"4324","Ilse","F","33","24",57
"4378","Sera","F","33","24",57
"4390","Amarianna","F","32","25",57
"4455","Mikaylah","F","32","25",57
"4482","Alisia","F","31","26",57
"4485","Anastazia","F","31","26",57
"4487","Annagrace","F","31","26",57
"4504","Elma","F","31","26",57
"4513","Imaan","F","31","26",57
"4537","Laniah","F","31","26",57
"4569","Adaley","F","30","27",57
"4576","Amaiyah","F","30","27",57
"4587","Atlas","F","30","27",57
"4588","Aubriee","F","30","27",57
"4593","Berlyn","F","30","27",57
"4602","Chisom","F","30","27",57
"4626","Jadah","F","30","27",57
"4632","Jayli","F","30","27",57
"4676","Ramya","F","30","27",57
"4685","Shaylin","F","30","27",57
"4718","Anagha","F","29","28",57
"4767","Kalissa","F","29","28",57
"4775","Keelie","F","29","28",57
"4800","Maylene","F","29","28",57
"4804","Mykenzie","F","29","28",57
"4846","Ariani","F","28","29",57
"4891","Kaeleigh","F","28","29",57
"4892","Kalee","F","28","29",57
"4900","Keyanna","F","28","29",57
"4936","Ranya","F","28","29",57
"5008","Ellaina","F","27","30",57
"5010","Emina","F","27","30",57
"5019","Harini","F","27","30",57
"5028","Jlynn","F","27","30",57
"5098","Unity","F","27","30",57
"5126","Aubriel","F","26","31",57
"5141","Debanhi","F","26","31",57
"5203","Laycee","F","26","31",57
"5231","Mirel","F","26","31",57
"5242","Raevyn","F","26","31",57
"5251","Scotlynn","F","26","31",57
"5254","Skilar","F","26","31",57
"5260","Suzie","F","26","31",57
"5271","Aerilyn","F","25","32",57
"5422","Varnika","F","25","32",57
"5553","Kelsy","F","24","33",57
"5558","Kobi","F","24","33",57
"5598","Novalynn","F","24","33",57
"5652","Arin","F","23","34",57
"5721","Kacee","F","23","34",57
"5791","Tanishka","F","23","34",57
"5884","Imari","F","22","35",57
"5942","Melodee","F","22","35",57
"5973","Riva","F","22","35",57
"6058","Cyra","F","21","36",57
"6070","Devany","F","21","36",57
"6351","Marleny","F","20","37",57
"4112","Raegyn","F","36","20",56
"4145","Breah","F","35","21",56
"4168","Ivyana","F","35","21",56
"4179","Kloie","F","35","21",56
"4291","Aleenah","F","33","23",56
"4296","Araiya","F","33","23",56
"4300","Aylee","F","33","23",56
"4326","Jacinta","F","33","23",56
"4380","Shayleigh","F","33","23",56
"4391","Amayrani","F","32","24",56
"4394","Amorah","F","32","24",56
"4405","Aurianna","F","32","24",56
"4411","Calise","F","32","24",56
"4441","Lakin","F","32","24",56
"4484","Allisyn","F","31","25",56
"4507","Eniyah","F","31","25",56
"4545","Maylie","F","31","25",56
"4556","Salena","F","31","25",56
"4579","Anapaula","F","30","26",56
"4603","Christelle","F","30","26",56
"4607","Darina","F","30","26",56
"4611","Dorcas","F","30","26",56
"4672","Perel","F","30","26",56
"4673","Priyanka","F","30","26",56
"4699","Viana","F","30","26",56
"4719","Analynn","F","29","27",56
"4784","Lanah","F","29","27",56
"4786","Lawson","F","29","27",56
"4820","Shanice","F","29","27",56
"4822","Soledad","F","29","27",56
"4833","Aissatou","F","28","28",56
"4843","Anilah","F","28","28",56
"4851","Asiah","F","28","28",56
"4909","Leianna","F","28","28",56
"4920","Mena","F","28","28",56
"5038","Lainie","F","27","29",56
"5051","Makinlee","F","27","29",56
"5060","Meryem","F","27","29",56
"5076","Reena","F","27","29",56
"5099","Vy","F","27","29",56
"5111","Alvina","F","26","30",56
"5120","Andria","F","26","30",56
"5143","Dianne","F","26","30",56
"5196","Kerry","F","26","30",56
"5246","Rielle","F","26","30",56
"5269","Zuzanna","F","26","30",56
"5298","Brecken","F","25","31",56
"5333","Genavieve","F","25","31",56
"5451","Alta","F","24","32",56
"5556","Keyra","F","24","32",56
"5584","Merry","F","24","32",56
"5601","Orly","F","24","32",56
"5665","Blakley","F","23","33",56
"5742","Maanvi","F","23","33",56
"5744","Maimouna","F","23","33",56
"5803","Ziana","F","23","33",56
"6054","Cosima","F","21","35",56
"6124","Laramie","F","21","35",56
"6256","Cameran","F","20","36",56
"3917","Chanell","F","38","17",55
"3991","Briel","F","37","18",55
"4132","Adelise","F","35","20",55
"4161","Falon","F","35","20",55
"4178","Kinnley","F","35","20",55
"4219","Allee","F","34","21",55
"4251","Lamiya","F","34","21",55
"4315","Elliemae","F","33","22",55
"4327","Jasiyah","F","33","22",55
"4348","Macayla","F","33","22",55
"4358","Naiara","F","33","22",55
"4386","Vibha","F","33","22",55
"4471","Zamara","F","32","23",55
"4475","Adaiah","F","31","24",55
"4506","Emmanuela","F","31","24",55
"4531","Keara","F","31","24",55
"4552","Parisa","F","31","24",55
"4562","Stefani","F","31","24",55
"4568","Aarvi","F","30","25",55
"4578","Ameria","F","30","25",55
"4601","Chastity","F","30","25",55
"4688","Stephania","F","30","25",55
"4705","Zanaya","F","30","25",55
"4729","Avigayil","F","29","26",55
"4756","Jamari","F","29","26",55
"4771","Karin","F","29","26",55
"4803","Miraya","F","29","26",55
"4814","Sammi","F","29","26",55
"4829","Zanyah","F","29","26",55
"4844","Annaly","F","28","27",55
"4849","Arlie","F","28","27",55
"4879","Halen","F","28","27",55
"4885","Jalaysia","F","28","27",55
"4946","Samora","F","28","27",55
"4948","Shahd","F","28","27",55
"4953","Skyelar","F","28","27",55
"4958","Uriah","F","28","27",55
"4999","Chrislynn","F","27","28",55
"5005","Doreen","F","27","28",55
"5043","Loyal","F","27","28",55
"5044","Lyana","F","27","28",55
"5052","Maranda","F","27","28",55
"5064","Nailea","F","27","28",55
"5130","Awa","F","26","29",55
"5178","Jerzee","F","26","29",55
"5233","Naimah","F","26","29",55
"5270","Aamiyah","F","25","30",55
"5370","Lahna","F","25","30",55
"5371","Laiya","F","25","30",55
"5433","Aaira","F","24","31",55
"5475","Brienna","F","24","31",55
"5518","Jakyla","F","24","31",55
"5547","Kandice","F","24","31",55
"5562","Lee","F","24","31",55
"5682","Deana","F","23","32",55
"5723","Karlyn","F","23","32",55
"5728","Keelyn","F","23","32",55
"5760","Mulan","F","23","32",55
"5812","Adelena","F","22","33",55
"5966","Orion","F","22","33",55
"6191","Tyana","F","21","34",55
"6246","Ayan","F","20","35",55
"6636","Renatta","F","19","36",55
"7145","Nari","F","17","38",55
"8294","Rheya","F","14","41",55
"11719","Islah","F","8","47",55
"4061","Aerial","F","36","18",54
"4095","Kenly","F","36","18",54
"4152","Delyla","F","35","19",54
"4185","Mackenzy","F","35","19",54
"4249","Kirah","F","34","20",54
"4337","Kaysen","F","33","21",54
"4403","Arley","F","32","22",54
"4414","Devynn","F","32","22",54
"4417","Elivia","F","32","22",54
"4490","Azayla","F","31","23",54
"4561","Stacie","F","31","23",54
"4574","Alyiah","F","30","24",54
"4609","Deysi","F","30","24",54
"4620","Forever","F","30","24",54
"4681","Sarahy","F","30","24",54
"4694","Tionna","F","30","24",54
"4700","Vita","F","30","24",54
"4721","Angelynn","F","29","25",54
"4752","Hafsah","F","29","25",54
"4765","Julienne","F","29","25",54
"4787","Leeana","F","29","25",54
"4864","Darci","F","28","26",54
"4865","Debbie","F","28","26",54
"4877","Georgianna","F","28","26",54
"4890","Jumana","F","28","26",54
"4894","Karalyn","F","28","26",54
"4912","Liani","F","28","26",54
"4927","Oliva","F","28","26",54
"4941","Roisin","F","28","26",54
"4943","Rumi","F","28","26",54
"4947","Seanna","F","28","26",54
"4952","Sheena","F","28","26",54
"4960","Wylie","F","28","26",54
"4980","Atlee","F","27","27",54
"4995","Callahan","F","27","27",54
"5007","Elijah","F","27","27",54
"5015","Gwendolen","F","27","27",54
"5027","Jessiah","F","27","27",54
"5036","Kyiah","F","27","27",54
"5048","Mahala","F","27","27",54
"5059","Meleah","F","27","27",54
"5083","Sadee","F","27","27",54
"5116","Amiliana","F","26","28",54
"5117","Amori","F","26","28",54
"5123","Arlee","F","26","28",54
"5146","Eliot","F","26","28",54
"5157","Finn","F","26","28",54
"5170","Ilaria","F","26","28",54
"5187","Katara","F","26","28",54
"5225","Mehar","F","26","28",54
"5241","Quetzaly","F","26","28",54
"5245","Rheagan","F","26","28",54
"5279","Analie","F","25","29",54
"5319","Elizaveta","F","25","29",54
"5348","Janiyla","F","25","29",54
"5410","Sallie","F","25","29",54
"5411","Savina","F","25","29",54
"5431","Zianna","F","25","29",54
"5461","Annslee","F","24","30",54
"5481","Casandra","F","24","30",54
"5532","Jeannie","F","24","30",54
"5541","Kaavya","F","24","30",54
"5599","Nyelle","F","24","30",54
"5608","Ruthann","F","24","30",54
"5625","Wanda","F","24","30",54
"5644","Ameliana","F","23","31",54
"5685","Deniz","F","23","31",54
"5697","Fatma","F","23","31",54
"5762","Naylani","F","23","31",54
"5792","Tracey","F","23","31",54
"5854","Dakoda","F","22","32",54
"5991","Suhana","F","22","32",54
"6031","Aolani","F","21","33",54
"6033","Archer","F","21","33",54
"6193","Vanity","F","21","33",54
"6364","Mithra","F","20","34",54
"4166","Hali","F","35","18",53
"4233","Elexis","F","34","19",53
"4266","Neala","F","34","19",53
"4328","Jasmyne","F","33","20",53
"4335","Kathia","F","33","20",53
"4352","Mayci","F","33","20",53
"4395","Amorie","F","32","21",53
"4467","Suraya","F","32","21",53
"4519","Jenifer","F","31","22",53
"4525","Kadie","F","31","22",53
"4600","Carolyne","F","30","23",53
"4617","Etty","F","30","23",53
"4629","Janis","F","30","23",53
"4643","Kayah","F","30","23",53
"4710","Acelyn","F","29","24",53
"4723","Annalea","F","29","24",53
"4725","Areej","F","29","24",53
"4751","Hadiya","F","29","24",53
"4811","Rylyn","F","29","24",53
"4878","Habiba","F","28","25",53
"4881","Issa","F","28","25",53
"4899","Kenli","F","28","25",53
"4911","Leighann","F","28","25",53
"4955","Stori","F","28","25",53
"4956","Syncere","F","28","25",53
"4966","Zlata","F","28","25",53
"4977","Arianni","F","27","26",53
"4982","Avree","F","27","26",53
"4983","Aziah","F","27","26",53
"4984","Bahar","F","27","26",53
"5086","Samanta","F","27","26",53
"5087","Samanvi","F","27","26",53
"5113","Amarii","F","26","27",53
"5122","Anyeli","F","26","27",53
"5127","Augustine","F","26","27",53
"5135","Celena","F","26","27",53
"5207","Maddy","F","26","27",53
"5212","Makenzee","F","26","27",53
"5217","Mariely","F","26","27",53
"5229","Meya","F","26","27",53
"5240","Oliviana","F","26","27",53
"5247","Rona","F","26","27",53
"5250","Saliyah","F","26","27",53
"5256","Stassi","F","26","27",53
"5257","Suhayla","F","26","27",53
"5300","Cady","F","25","28",53
"5354","Juliann","F","25","28",53
"5380","Malayia","F","25","28",53
"5400","Quinlan","F","25","28",53
"5406","Roni","F","25","28",53
"5407","Ronni","F","25","28",53
"5432","Zina","F","25","28",53
"5495","Dulcemaria","F","24","29",53
"5554","Kendalynn","F","24","29",53
"5605","Reanna","F","24","29",53
"5657","Aubrii","F","23","30",53
"5799","Zamirah","F","23","30",53
"5974","Rosabelle","F","22","31",53
"6010","Zana","F","22","31",53
"6080","Erina","F","21","32",53
"6092","Heily","F","21","32",53
"6113","Kashlyn","F","21","32",53
"6148","Mecca","F","21","32",53
"6344","Lynnox","F","20","33",53
"6562","Ksenia","F","19","34",53
"6618","Paislynn","F","19","34",53
"6716","Anette","F","18","35",53
"6968","Anaelle","F","17","36",53
"7300","Bodhi","F","16","37",53
"4211","Zamaria","F","35","17",52
"4342","Kolbi","F","33","19",52
"4355","Mikaella","F","33","19",52
"4363","Onna","F","33","19",52
"4499","Corah","F","31","21",52
"4517","Jatziry","F","31","21",52
"4554","Rivers","F","31","21",52
"4564","Tate","F","31","21",52
"4580","Anastasiya","F","30","22",52
"4583","Anijah","F","30","22",52
"4616","Emonie","F","30","22",52
"4625","Jackelin","F","30","22",52
"4675","Rachell","F","30","22",52
"4684","Shaye","F","30","22",52
"4720","Aneesa","F","29","23",52
"4728","Assata","F","29","23",52
"4740","Eliany","F","29","23",52
"4744","Evah","F","29","23",52
"4821","Shauna","F","29","23",52
"4823","Sundus","F","29","23",52
"4840","Allyana","F","28","24",52
"4929","Pressley","F","28","24",52
"4949","Shamiyah","F","28","24",52
"4957","Tehya","F","28","24",52
"4961","Yulisa","F","28","24",52
"4991","Breonna","F","27","25",52
"4997","Cecile","F","27","25",52
"5016","Gwenivere","F","27","25",52
"5023","Israa","F","27","25",52
"5026","Jazaria","F","27","25",52
"5031","Karizma","F","27","25",52
"5037","Laiba","F","27","25",52
"5041","Leina","F","27","25",52
"5045","Maanya","F","27","25",52
"5131","Breann","F","26","26",52
"5139","Christabel","F","26","26",52
"5223","Medina","F","26","26",52
"5288","Auriel","F","25","27",52
"5304","Charm","F","25","27",52
"5339","Illyana","F","25","27",52
"5349","Jayah","F","25","27",52
"5351","Jerrica","F","25","27",52
"5405","Roman","F","25","27",52
"5419","Tehila","F","25","27",52
"5421","Twyla","F","25","27",52
"5426","Xia","F","25","27",52
"5452","Alyric","F","24","28",52
"5542","Kaedyn","F","24","28",52
"5589","Naleah","F","24","28",52
"5592","Nayah","F","24","28",52
"5593","Neena","F","24","28",52
"5614","Shamya","F","24","28",52
"5617","Tasia","F","24","28",52
"5627","Winslow","F","24","28",52
"5667","Brinnley","F","23","29",52
"5673","Cassadee","F","23","29",52
"5677","Cloey","F","23","29",52
"5765","Nysa","F","23","29",52
"5782","Sharlene","F","23","29",52
"5790","Tanaya","F","23","29",52
"5805","Zurie","F","23","29",52
"5962","Naysa","F","22","30",52
"5967","Parnika","F","22","30",52
"5978","Saffron","F","22","30",52
"6116","Kerri","F","21","31",52
"6295","Island","F","20","32",52
"6803","Imelda","F","18","34",52
"4151","Daysha","F","35","16",51
"4207","Thais","F","35","16",51
"4217","Adalae","F","34","17",51
"4229","Caprice","F","34","17",51
"4232","Dayelin","F","34","17",51
"4292","Alexsandra","F","33","18",51
"4313","Elah","F","33","18",51
"4339","Kennadee","F","33","18",51
"4366","Reet","F","33","18",51
"4410","Calianna","F","32","19",51
"4425","Halia","F","32","19",51
"4454","Mica","F","32","19",51
"4483","Allanah","F","31","20",51
"4572","Alitza","F","30","21",51
"4591","Avry","F","30","21",51
"4650","Loralie","F","30","21",51
"4658","Mattilyn","F","30","21",51
"4702","Wilma","F","30","21",51
"4748","Getsemani","F","29","22",51
"4749","Gisell","F","29","22",51
"4777","Kieran","F","29","22",51
"4810","Quincey","F","29","22",51
"4815","Sari","F","29","22",51
"4818","Sela","F","29","22",51
"4819","September","F","29","22",51
"4837","Alexie","F","28","23",51
"4841","Alyx","F","28","23",51
"4852","Auriana","F","28","23",51
"4853","Austynn","F","28","23",51
"4896","Kayce","F","28","23",51
"4913","Liliann","F","28","23",51
"4926","Niyla","F","28","23",51
"4934","Rainy","F","28","23",51
"4935","Raiya","F","28","23",51
"5034","Kendell","F","27","24",51
"5040","Leda","F","27","24",51
"5070","Pranavi","F","27","24",51
"5094","Tennessee","F","27","24",51
"5097","Trenity","F","27","24",51
"5103","Ziona","F","27","24",51
"5105","Zyriah","F","27","24",51
"5115","Amery","F","26","25",51
"5132","Briah","F","26","25",51
"5137","Charissa","F","26","25",51
"5149","Ellyn","F","26","25",51
"5160","Freedom","F","26","25",51
"5168","Hayes","F","26","25",51
"5188","Kathrine","F","26","25",51
"5191","Kaylianna","F","26","25",51
"5193","Kayra","F","26","25",51
"5194","Keilah","F","26","25",51
"5220","Mattea","F","26","25",51
"5221","Maysen","F","26","25",51
"5235","Nishka","F","26","25",51
"5297","Berlynn","F","25","26",51
"5306","Chiamaka","F","25","26",51
"5320","Ellanora","F","25","26",51
"5323","Emmilyn","F","25","26",51
"5437","Abbi","F","24","27",51
"5450","Alizee","F","24","27",51
"5459","Anila","F","24","27",51
"5471","Bintou","F","24","27",51
"5474","Briasia","F","24","27",51
"5503","Ellyson","F","24","27",51
"5508","Eshal","F","24","27",51
"5546","Kamori","F","24","27",51
"5659","Avalene","F","23","28",51
"5719","Julieanna","F","23","28",51
"5766","Oceana","F","23","28",51
"5773","Rhythm","F","23","28",51
"5778","Sayla","F","23","28",51
"5872","Fae","F","22","29",51
"5875","Genisis","F","22","29",51
"5926","Larkyn","F","22","29",51
"5931","Mable","F","22","29",51
"5981","Savvy","F","22","29",51
"6030","Annaliyah","F","21","30",51
"6086","Giavana","F","21","30",51
"6152","Melaina","F","21","30",51
"6182","Sitara","F","21","30",51
"6201","Yuki","F","21","30",51
"6406","Vasilisa","F","20","31",51
"6408","Yanira","F","20","31",51
"6542","Kaizley","F","19","32",51
"7113","Lyrica","F","17","34",51
"7149","Nefertari","F","17","34",51
"4279","Sommer","F","34","16",50
"4375","Saryah","F","33","17",50
"4419","Emili","F","32","18",50
"4424","Guiliana","F","32","18",50
"4446","Lyndi","F","32","18",50
"4477","Adysen","F","31","19",50
"4551","Odyssey","F","31","19",50
"4613","Ellerie","F","30","20",50
"4641","Katharina","F","30","20",50
"4714","Alesana","F","29","21",50
"4724","Annastyn","F","29","21",50
"4739","Elektra","F","29","21",50
"4779","Korina","F","29","21",50
"4780","Kristyn","F","29","21",50
"4791","Lyllian","F","29","21",50
"4796","Marelyn","F","29","21",50
"4850","Aryelle","F","28","22",50
"4855","Ayiana","F","28","22",50
"4897","Keasia","F","28","22",50
"4898","Kelley","F","28","22",50
"4930","Quin","F","28","22",50
"4939","Ridhi","F","28","22",50
"4970","Afnan","F","27","23",50
"5017","Halina","F","27","23",50
"5033","Kayzlee","F","27","23",50
"5053","Maricruz","F","27","23",50
"5075","Raisa","F","27","23",50
"5155","Faustina","F","26","24",50
"5169","Ilah","F","26","24",50
"5195","Kennadie","F","26","24",50
"5199","Krishna","F","26","24",50
"5214","Makylah","F","26","24",50
"5218","Marylin","F","26","24",50
"5219","Mathilde","F","26","24",50
"5234","Nevada","F","26","24",50
"5253","Skarlet","F","26","24",50
"5264","Tenlee","F","26","24",50
"5307","Christal","F","25","25",50
"5316","Deetya","F","25","25",50
"5357","Kaylanie","F","25","25",50
"5360","Kemora","F","25","25",50
"5367","Krithi","F","25","25",50
"5393","Nataley","F","25","25",50
"5395","Neila","F","25","25",50
"5456","Anahy","F","24","26",50
"5458","Angelic","F","24","26",50
"5460","Annarose","F","24","26",50
"5467","Aviya","F","24","26",50
"5488","Danah","F","24","26",50
"5492","Davis","F","24","26",50
"5499","Eleena","F","24","26",50
"5505","Emeli","F","24","26",50
"5517","Jaiyana","F","24","26",50
"5519","Jakyra","F","24","26",50
"5526","Jaxyn","F","24","26",50
"5535","Jezebel","F","24","26",50
"5537","Jocelin","F","24","26",50
"5602","Parris","F","24","26",50
"5611","Sagan","F","24","26",50
"5663","Basma","F","23","27",50
"5707","Infinity","F","23","27",50
"5711","Jadzia","F","23","27",50
"5735","Leelah","F","23","27",50
"5746","Marnie","F","23","27",50
"5787","Sona","F","23","27",50
"5796","Veyda","F","23","27",50
"5811","Adelaine","F","22","28",50
"5826","Annali","F","22","28",50
"5842","Avyn","F","22","28",50
"5861","Dreya","F","22","28",50
"5895","Javeah","F","22","28",50
"6004","Winnifred","F","22","28",50
"6008","Zaidee","F","22","28",50
"6082","Ezmae","F","21","29",50
"6088","Gurnoor","F","21","29",50
"6252","Braxtyn","F","20","30",50
"6337","Lilibeth","F","20","30",50
"6409","Yeimy","F","20","30",50
"6483","Charvi","F","19","31",50
"6626","Perl","F","19","31",50
"6631","Rayana","F","19","31",50
"6804","Indya","F","18","32",50
"7075","Kaija","F","17","33",50
"7589","Ailen","F","15","35",50
"4429","Jayani","F","32","17",49
"4434","Kailea","F","32","17",49
"4436","Kambry","F","32","17",49
"4590","Aurea","F","30","19",49
"4630","Janyah","F","30","19",49
"4653","Maiyah","F","30","19",49
"4687","Spirit","F","30","19",49
"4712","Aidyn","F","29","20",49
"4717","Amylia","F","29","20",49
"4738","Dariah","F","29","20",49
"4762","Jatziri","F","29","20",49
"4783","Laiklyn","F","29","20",49
"4869","Eiley","F","28","21",49
"4880","Indra","F","28","21",49
"4923","Muriel","F","28","21",49
"4928","Payden","F","28","21",49
"4987","Bibiana","F","27","22",49
"4994","Calee","F","27","22",49
"4996","Callee","F","27","22",49
"5001","Cruz","F","27","22",49
"5002","Daizy","F","27","22",49
"5012","Favor","F","27","22",49
"5025","Jasey","F","27","22",49
"5057","Maylynn","F","27","22",49
"5078","Rishika","F","27","22",49
"5085","Safiyyah","F","27","22",49
"5091","Shyanna","F","27","22",49
"5102","Zaydee","F","27","22",49
"5140","Daysi","F","26","23",49
"5167","Hartlee","F","26","23",49
"5171","Ione","F","26","23",49
"5183","Kallee","F","26","23",49
"5211","Maile","F","26","23",49
"5268","Xoe","F","26","23",49
"5289","Aviona","F","25","24",49
"5308","Corie","F","25","24",49
"5322","Elloise","F","25","24",49
"5326","Everette","F","25","24",49
"5344","Jadalyn","F","25","24",49
"5346","Janella","F","25","24",49
"5347","Janiece","F","25","24",49
"5373","Lejla","F","25","24",49
"5414","Shaindel","F","25","24",49
"5416","Siri","F","25","24",49
"5420","Timia","F","25","24",49
"5424","Viviann","F","25","24",49
"5446","Aiko","F","24","25",49
"5478","Camber","F","24","25",49
"5497","Eily","F","24","25",49
"5509","Evaline","F","24","25",49
"5515","Jackson","F","24","25",49
"5523","Jamyra","F","24","25",49
"5524","Jaselle","F","24","25",49
"5539","Jonah","F","24","25",49
"5573","Mairead","F","24","25",49
"5590","Natania","F","24","25",49
"5609","Ryli","F","24","25",49
"5704","Hazelle","F","23","26",49
"5713","Jamyla","F","23","26",49
"5731","Kera","F","23","26",49
"5733","Laikynn","F","23","26",49
"5737","Legaci","F","23","26",49
"5748","Maryellen","F","23","26",49
"5775","Rosita","F","23","26",49
"5813","Adler","F","22","27",49
"5821","Ameila","F","22","27",49
"5831","Armonie","F","22","27",49
"5840","Avianah","F","22","27",49
"5857","Danitza","F","22","27",49
"5922","Korinne","F","22","27",49
"6015","Zyasia","F","22","27",49
"6027","Anayla","F","21","28",49
"6055","Courtlyn","F","21","28",49
"6066","Declan","F","21","28",49
"6102","Jazzmine","F","21","28",49
"6211","Adalaide","F","20","29",49
"6342","Loxley","F","20","29",49
"6375","Nuri","F","20","29",49
"6405","Tyonna","F","20","29",49
"6417","Zunairah","F","20","29",49
"6442","Amarissa","F","19","30",49
"6449","Anevay","F","19","30",49
"6564","Kylen","F","19","30",49
"6644","Royalti","F","19","30",49
"6926","Torri","F","18","31",49
"7280","Arynn","F","16","33",49
"7367","Hazelynn","F","16","33",49
"7722","Heiress","F","15","34",49
"9377","Ailish","F","11","38",49
"4692","Tamari","F","30","18",48
"4742","Emiley","F","29","19",48
"4750","Gwynn","F","29","19",48
"4761","Jasmina","F","29","19",48
"4793","Madilynne","F","29","19",48
"4875","Franki","F","28","20",48
"4918","Mataya","F","28","20",48
"4924","Myleigh","F","28","20",48
"5030","Kamoni","F","27","21",48
"5042","Loreal","F","27","21",48
"5058","Meika","F","27","21",48
"5065","Nakiyah","F","27","21",48
"5109","Alayia","F","26","22",48
"5114","Amauri","F","26","22",48
"5136","Celestina","F","26","22",48
"5142","Deliah","F","26","22",48
"5175","Jamira","F","26","22",48
"5181","July","F","26","22",48
"5201","Kristie","F","26","22",48
"5213","Makya","F","26","22",48
"5228","Menaal","F","26","22",48
"5237","Nizhoni","F","26","22",48
"5276","Alley","F","25","23",48
"5287","Aryam","F","25","23",48
"5313","Damoni","F","25","23",48
"5350","Jeanna","F","25","23",48
"5361","Keniyah","F","25","23",48
"5378","Magdalyn","F","25","23",48
"5434","Aamina","F","24","24",48
"5472","Blaise","F","24","24",48
"5473","Breeze","F","24","24",48
"5510","Evany","F","24","24",48
"5552","Keirra","F","24","24",48
"5560","Kristi","F","24","24",48
"5569","Lyndon","F","24","24",48
"5595","Neyla","F","24","24",48
"5610","Sadia","F","24","24",48
"5613","Seriyah","F","24","24",48
"5649","Analiz","F","23","25",48
"5658","Audrielle","F","23","25",48
"5671","Camia","F","23","25",48
"5696","Evaluna","F","23","25",48
"5699","Gracelynne","F","23","25",48
"5712","Jae","F","23","25",48
"5714","Jazariah","F","23","25",48
"5736","Leeyah","F","23","25",48
"5751","Maverick","F","23","25",48
"5802","Zen","F","23","25",48
"5851","Cleopatra","F","22","26",48
"5853","Cyan","F","22","26",48
"5864","Ellamarie","F","22","26",48
"5873","Filomena","F","22","26",48
"5876","Griffin","F","22","26",48
"5979","Samayah","F","22","26",48
"5988","Siyah","F","22","26",48
"6047","Camiya","F","21","27",48
"6048","Camry","F","21","27",48
"6067","Delfina","F","21","27",48
"6126","Launa","F","21","27",48
"6199","Yaneth","F","21","27",48
"6214","Aerith","F","20","28",48
"6306","Jorie","F","20","28",48
"6343","Luzmaria","F","20","28",48
"6374","Novalie","F","20","28",48
"6467","Avangeline","F","19","29",48
"6523","Imara","F","19","29",48
"6548","Kamyra","F","19","29",48
"6552","Kelise","F","19","29",48
"6583","Maddix","F","19","29",48
"6596","Marykate","F","19","29",48
"6700","Allura","F","18","30",48
"6710","Amreen","F","18","30",48
"6898","Runa","F","18","30",48
"6951","Adanna","F","17","31",48
"7026","Eh","F","17","31",48
"7104","Liliya","F","17","31",48
"8086","Elenora","F","14","34",48
"4381","Shaylyn","F","33","14",47
"4400","Annasophia","F","32","15",47
"4592","Bellah","F","30","17",47
"4622","Gloriana","F","30","17",47
"4646","Kilee","F","30","17",47
"4759","Jamyiah","F","29","18",47
"4763","Joshlyn","F","29","18",47
"4781","Krystina","F","29","18",47
"4834","Ajla","F","28","19",47
"4856","Ayomide","F","28","19",47
"4861","Corra","F","28","19",47
"4872","Evalynne","F","28","19",47
"4883","Jacinda","F","28","19",47
"4914","Lizzy","F","28","19",47
"4931","Raeann","F","28","19",47
"4938","Rayden","F","28","19",47
"4965","Zeena","F","28","19",47
"4988","Blen","F","27","20",47
"5004","Deirdre","F","27","20",47
"5067","Nashly","F","27","20",47
"5068","Noemie","F","27","20",47
"5118","Amran","F","26","21",47
"5134","Cari","F","26","21",47
"5154","Fatema","F","26","21",47
"5156","Fia","F","26","21",47
"5159","Fradel","F","26","21",47
"5165","Gypsy","F","26","21",47
"5172","Irlanda","F","26","21",47
"5174","Ivyonna","F","26","21",47
"5176","Janayah","F","26","21",47
"5215","Maniyah","F","26","21",47
"5226","Melah","F","26","21",47
"5244","Ravenna","F","26","21",47
"5263","Tehilla","F","26","21",47
"5265","Tommie","F","26","21",47
"5295","Batya","F","25","22",47
"5314","Dannie","F","25","22",47
"5343","Jabria","F","25","22",47
"5353","Josslynn","F","25","22",47
"5364","Khalessi","F","25","22",47
"5368","Kyana","F","25","22",47
"5399","Noreen","F","25","22",47
"5402","Remmi","F","25","22",47
"5408","Ruchy","F","25","22",47
"5413","Shailene","F","25","22",47
"5429","Zelia","F","25","22",47
"5514","Havilah","F","24","23",47
"5544","Kaloni","F","24","23",47
"5563","Lenyx","F","24","23",47
"5577","Manar","F","24","23",47
"5580","Maryella","F","24","23",47
"5585","Mirah","F","24","23",47
"5604","Quorra","F","24","23",47
"5607","Riddhi","F","24","23",47
"5634","Zaryiah","F","24","23",47
"5662","Ayumi","F","23","24",47
"5679","Dariela","F","23","24",47
"5695","Esmerelda","F","23","24",47
"5698","Finnleigh","F","23","24",47
"5747","Maryalice","F","23","24",47
"5771","Raziya","F","23","24",47
"5793","Trudy","F","23","24",47
"5804","Zowie","F","23","24",47
"5806","Zyaire","F","23","24",47
"5818","Alahia","F","22","25",47
"5855","Dalexa","F","22","25",47
"5862","Dru","F","22","25",47
"5910","Kaleyah","F","22","25",47
"5911","Kallista","F","22","25",47
"5929","Lilya","F","22","25",47
"5935","Malana","F","22","25",47
"5964","Noemy","F","22","25",47
"5986","Siara","F","22","25",47
"6063","Darling","F","21","26",47
"6093","Huxley","F","21","26",47
"6112","Karena","F","21","26",47
"6132","Lilyth","F","21","26",47
"6160","Neah","F","21","26",47
"6197","Willamina","F","21","26",47
"6223","Aluna","F","20","27",47
"6297","Jaelee","F","20","27",47
"6363","Mireille","F","20","27",47
"6386","Ruqayyah","F","20","27",47
"6403","Tasnim","F","20","27",47
"6419","Aairah","F","19","28",47
"6494","Duaa","F","19","28",47
"6519","Hazelyn","F","19","28",47
"6598","Meenakshi","F","19","28",47
"6657","Shantel","F","19","28",47
"6767","Devan","F","18","29",47
"7012","Daira","F","17","30",47
"7188","Sheryl","F","17","30",47
"7397","Kaida","F","16","31",47
"7533","Tavia","F","16","31",47
"8404","Adhira","F","13","34",47
"4498","Carma","F","31","15",46
"4549","Nashley","F","31","15",46
"4606","Cortana","F","30","16",46
"4698","Varsha","F","30","16",46
"4726","Arial","F","29","17",46
"4770","Karalynn","F","29","17",46
"4838","Alexzandria","F","28","18",46
"4857","Braelee","F","28","18",46
"4981","Aubreanna","F","27","19",46
"4990","Brealynn","F","27","19",46
"4992","Breya","F","27","19",46
"5022","Inna","F","27","19",46
"5046","Madeleyn","F","27","19",46
"5161","Genesys","F","26","20",46
"5227","Mele","F","26","20",46
"5261","Svetlana","F","26","20",46
"5281","Anyiah","F","25","21",46
"5284","Arilyn","F","25","21",46
"5311","Dalis","F","25","21",46
"5383","Manya","F","25","21",46
"5403","Richelle","F","25","21",46
"5417","Suhaylah","F","25","21",46
"5489","Danyelle","F","24","22",46
"5545","Kamber","F","24","22",46
"5549","Kassidee","F","24","22",46
"5578","Margeaux","F","24","22",46
"5586","Miyana","F","24","22",46
"5623","Verona","F","24","22",46
"5636","Aalyiah","F","23","23",46
"5646","Amri","F","23","23",46
"5670","Caley","F","23","23",46
"5681","Dea","F","23","23",46
"5686","Dorian","F","23","23",46
"5700","Hadeel","F","23","23",46
"5705","Helaina","F","23","23",46
"5722","Kalianna","F","23","23",46
"5761","Naiyah","F","23","23",46
"5769","Quinnlyn","F","23","23",46
"5798","Zaire","F","23","23",46
"5845","Brittyn","F","22","24",46
"5871","Enna","F","22","24",46
"5877","Hailyn","F","22","24",46
"5888","Ixchel","F","22","24",46
"5963","Nevayah","F","22","24",46
"5996","Teanna","F","22","24",46
"6000","Twila","F","22","24",46
"6002","Vela","F","22","24",46
"6053","Copeland","F","21","25",46
"6097","Jala","F","21","25",46
"6107","Josselin","F","21","25",46
"6207","Zuleika","F","21","25",46
"6261","Dayami","F","20","26",46
"6269","Eliah","F","20","26",46
"6334","Laylanie","F","20","26",46
"6357","Menucha","F","20","26",46
"6372","Niki","F","20","26",46
"6373","Nixon","F","20","26",46
"6387","Sansa","F","20","26",46
"6443","Amayra","F","19","27",46
"6487","Crosby","F","19","27",46
"6497","Elysa","F","19","27",46
"6541","Kaislee","F","19","27",46
"6613","Nusaybah","F","19","27",46
"6652","Saskia","F","19","27",46
"6684","Zuriel","F","19","27",46
"6719","Ariam","F","18","28",46
"6758","Davianna","F","18","28",46
"6931","Vaani","F","18","28",46
"6939","Yzabella","F","18","28",46
"7054","Indica","F","17","29",46
"7266","Amylah","F","16","30",46
"8082","Edelyn","F","14","32",46
"8349","Teyanna","F","14","32",46
"4259","Mackynzie","F","34","11",45
"4493","Brigette","F","31","14",45
"4496","Calissa","F","31","14",45
"4732","Briza","F","29","16",45
"4747","Galileah","F","29","16",45
"4757","Jameria","F","29","16",45
"4773","Kaysie","F","29","16",45
"4774","Kaytlin","F","29","16",45
"4812","Sachi","F","29","16",45
"4830","Zerenity","F","29","16",45
"4845","Anyssa","F","28","17",45
"4862","Cozette","F","28","17",45
"4907","Laveah","F","28","17",45
"4964","Zailynn","F","28","17",45
"4973","Akayla","F","27","18",45
"5101","Yanelly","F","27","18",45
"5107","Adilee","F","26","19",45
"5110","Alexiana","F","26","19",45
"5121","Anusha","F","26","19",45
"5166","Harlym","F","26","19",45
"5192","Kaylinn","F","26","19",45
"5238","Nuha","F","26","19",45
"5272","Alahni","F","25","20",45
"5302","Camrynn","F","25","20",45
"5303","Cassidee","F","25","20",45
"5337","Hanah","F","25","20",45
"5385","Marylou","F","25","20",45
"5386","Mianna","F","25","20",45
"5430","Zephyr","F","25","20",45
"5438","Adabelle","F","24","21",45
"5511","Faithlyn","F","24","21",45
"5533","Jenae","F","24","21",45
"5566","Lua","F","24","21",45
"5574","Maison","F","24","21",45
"5615","Signe","F","24","21",45
"5641","Aleisha","F","23","22",45
"5664","Batoul","F","23","22",45
"5687","Elenore","F","23","22",45
"5701","Hajar","F","23","22",45
"5745","Maleya","F","23","22",45
"5763","Noriah","F","23","22",45
"5797","Zaelyn","F","23","22",45
"5829","Arilynn","F","22","23",45
"5848","Caliah","F","22","23",45
"5852","Connor","F","22","23",45
"5879","Hinata","F","22","23",45
"5883","Illianna","F","22","23",45
"5891","Jaimie","F","22","23",45
"5900","Jennavieve","F","22","23",45
"5919","Kiyana","F","22","23",45
"5995","Tamsin","F","22","23",45
"6023","Amada","F","21","24",45
"6025","Analis","F","21","24",45
"6038","Audie","F","21","24",45
"6108","Joud","F","21","24",45
"6109","Joya","F","21","24",45
"6114","Kemani","F","21","24",45
"6177","Semira","F","21","24",45
"6206","Zenia","F","21","24",45
"6247","Azriel","F","20","25",45
"6263","Delores","F","20","25",45
"6274","Erza","F","20","25",45
"6291","Hamdi","F","20","25",45
"6318","Katty","F","20","25",45
"6329","Kyri","F","20","25",45
"6433","Alainna","F","19","26",45
"6435","Aleiyah","F","19","26",45
"6439","Alva","F","19","26",45
"6473","Brianda","F","19","26",45
"6530","Jarely","F","19","26",45
"6540","Kaidynce","F","19","26",45
"6561","Kristianna","F","19","26",45
"6603","Meylin","F","19","26",45
"6617","Paighton","F","19","26",45
"6662","Shree","F","19","26",45
"6691","Aerin","F","18","27",45
"6845","Leilanni","F","18","27",45
"6853","Lynnette","F","18","27",45
"6899","Rut","F","18","27",45
"7105","Lilo","F","17","28",45
"7228","Zephaniah","F","17","28",45
"7230","Zyanya","F","17","28",45
"7516","Shanel","F","16","29",45
"7549","Ximenna","F","16","29",45
"8703","Miesha","F","13","32",45
"11589","Danelly","F","8","37",45
"4459","Nicoletta","F","32","12",44
"4530","Katelin","F","31","13",44
"4605","Cobie","F","30","14",44
"4608","Delayza","F","30","14",44
"4782","Kylea","F","29","15",44
"4806","Nasya","F","29","15",44
"4816","Sayde","F","29","15",44
"4827","Yaslin","F","29","15",44
"4842","Ambria","F","28","16",44
"4859","Carmina","F","28","16",44
"4906","Lakayla","F","28","16",44
"4919","Meelah","F","28","16",44
"4950","Shani","F","28","16",44
"4985","Baylei","F","27","17",44
"4986","Betzaida","F","27","17",44
"5003","Dalayza","F","27","17",44
"5063","Nadiyah","F","27","17",44
"5071","Promyse","F","27","17",44
"5108","Alajah","F","26","18",44
"5185","Karianna","F","26","18",44
"5189","Kayana","F","26","18",44
"5230","Mikyla","F","26","18",44
"5255","Sonny","F","26","18",44
"5266","Tonya","F","26","18",44
"5277","Allyanna","F","25","19",44
"5292","Azelia","F","25","19",44
"5321","Ellise","F","25","19",44
"5355","Justus","F","25","19",44
"5365","Killian","F","25","19",44
"5394","Natalina","F","25","19",44
"5401","Raylie","F","25","19",44
"5435","Aanika","F","24","20",44
"5445","Aidan","F","24","20",44
"5454","Ambrielle","F","24","20",44
"5457","Anavictoria","F","24","20",44
"5462","Anvita","F","24","20",44
"5464","Ariona","F","24","20",44
"5469","Ayse","F","24","20",44
"5516","Jaia","F","24","20",44
"5522","Jalena","F","24","20",44
"5551","Keana","F","24","20",44
"5557","Keysha","F","24","20",44
"5565","Lochlyn","F","24","20",44
"5576","Malania","F","24","20",44
"5579","Maryana","F","24","20",44
"5616","Solei","F","24","20",44
"5622","Van","F","24","20",44
"5628","Xandria","F","24","20",44
"5666","Blessin","F","23","21",44
"5693","Emmalynne","F","23","21",44
"5750","Matea","F","23","21",44
"5754","Meliyah","F","23","21",44
"5768","Persia","F","23","21",44
"5774","Rosina","F","23","21",44
"5800","Zaylynn","F","23","21",44
"5859","Delana","F","22","22",44
"5887","Ivee","F","22","22",44
"5893","Janyiah","F","22","22",44
"5914","Kandace","F","22","22",44
"5930","Lyliana","F","22","22",44
"5938","Mamie","F","22","22",44
"5954","Nadeen","F","22","22",44
"5987","Sila","F","22","22",44
"5990","Storie","F","22","22",44
"5992","Tahira","F","22","22",44
"6017","Aissata","F","21","23",44
"6024","Ameliya","F","21","23",44
"6034","Ardyn","F","21","23",44
"6045","Calynn","F","21","23",44
"6050","Chidera","F","21","23",44
"6138","Madelaine","F","21","23",44
"6139","Madi","F","21","23",44
"6165","Niva","F","21","23",44
"6192","Valorie","F","21","23",44
"6245","Avory","F","20","24",44
"6275","Evangelia","F","20","24",44
"6282","Geovanna","F","20","24",44
"6289","Hadia","F","20","24",44
"6314","Karolyn","F","20","24",44
"6319","Kayda","F","20","24",44
"6321","Kennya","F","20","24",44
"6333","Layanna","F","20","24",44
"6367","Naidelyn","F","20","24",44
"6368","Nataliah","F","20","24",44
"6370","Nehemiah","F","20","24",44
"6380","Quinnley","F","20","24",44
"6573","Leiani","F","19","25",44
"6584","Mahina","F","19","25",44
"6600","Melanee","F","19","25",44
"6709","Amory","F","18","26",44
"6723","Aviyah","F","18","26",44
"6748","Chrislyn","F","18","26",44
"6749","Conley","F","18","26",44
"6886","Owen","F","18","26",44
"6945","Aaniya","F","17","27",44
"6991","Bo","F","17","27",44
"7029","Eliani","F","17","27",44
"7068","Jeanine","F","17","27",44
"7241","Ahlani","F","16","28",44
"7342","Eleora","F","16","28",44
"7454","Melrose","F","16","28",44
"7627","Aveyah","F","15","29",44
"8373","Xareni","F","14","30",44
"8491","Caila","F","13","31",44
"8660","Lizabeth","F","13","31",44
"8715","Nainika","F","13","31",44
"4709","Abrish","F","29","14",43
"4944","Saachi","F","28","15",43
"4967","Aariana","F","27","16",43
"5011","Ezabella","F","27","16",43
"5032","Kasia","F","27","16",43
"5055","Marlayna","F","27","16",43
"5144","Disha","F","26","17",43
"5179","Jessika","F","26","17",43
"5190","Kaylana","F","26","17",43
"5202","Kyia","F","26","17",43
"5232","Nabila","F","26","17",43
"5280","Anjolaoluwa","F","25","18",43
"5299","Bristal","F","25","18",43
"5317","Eiliyah","F","25","18",43
"5335","Gurleen","F","25","18",43
"5362","Keyri","F","25","18",43
"5363","Keysi","F","25","18",43
"5375","Leylanie","F","25","18",43
"5440","Adama","F","24","19",43
"5444","Aerabella","F","24","19",43
"5455","Amilliana","F","24","19",43
"5476","Brixton","F","24","19",43
"5477","Bruchy","F","24","19",43
"5490","Daphney","F","24","19",43
"5512","Fianna","F","24","19",43
"5561","Laiah","F","24","19",43
"5564","Lexani","F","24","19",43
"5581","Maybree","F","24","19",43
"5587","Myleah","F","24","19",43
"5632","Zania","F","24","19",43
"5650","Anasophia","F","23","20",43
"5661","Ayonna","F","23","20",43
"5676","Charlea","F","23","20",43
"5683","Declyn","F","23","20",43
"5691","Ellyse","F","23","20",43
"5694","Erabella","F","23","20",43
"5710","Jacquelynn","F","23","20",43
"5729","Keilly","F","23","20",43
"5755","Merari","F","23","20",43
"5759","Mimi","F","23","20",43
"5780","Shamiya","F","23","20",43
"5794","Tyliah","F","23","20",43
"5847","Brynli","F","22","21",43
"5867","Emmalie","F","22","21",43
"5874","Fraya","F","22","21",43
"5901","Jennica","F","22","21",43
"5913","Kamorah","F","22","21",43
"5924","Kyliah","F","22","21",43
"5940","Mckenzy","F","22","21",43
"5941","Mekayla","F","22","21",43
"5955","Najah","F","22","21",43
"5957","Nana","F","22","21",43
"5970","Phyllis","F","22","21",43
"5972","Rhys","F","22","21",43
"5976","Ryver","F","22","21",43
"5985","Shreeya","F","22","21",43
"5998","Thora","F","22","21",43
"6026","Anara","F","21","22",43
"6071","Domenica","F","21","22",43
"6083","Flynn","F","21","22",43
"6085","Gabryella","F","21","22",43
"6094","Ifeoluwa","F","21","22",43
"6119","Kourtlyn","F","21","22",43
"6142","Mallori","F","21","22",43
"6143","Maryelizabeth","F","21","22",43
"6162","Neomi","F","21","22",43
"6172","Rosaly","F","21","22",43
"6184","Solveig","F","21","22",43
"6189","Teya","F","21","22",43
"6202","Zalaya","F","21","22",43
"6238","Arihanna","F","20","23",43
"6258","Carlynn","F","20","23",43
"6284","Ginny","F","20","23",43
"6414","Zeniyah","F","20","23",43
"6424","Addley","F","19","24",43
"6451","Angeliz","F","19","24",43
"6492","Deniyah","F","19","24",43
"6512","Gennesis","F","19","24",43
"6536","Jezabel","F","19","24",43
"6553","Kemiyah","F","19","24",43
"6565","Kynnedy","F","19","24",43
"6606","Mumtaz","F","19","24",43
"6635","Remmy","F","19","24",43
"6638","Renley","F","19","24",43
"6653","Saydie","F","19","24",43
"6661","Shoshanna","F","19","24",43
"6668","Tempest","F","19","24",43
"6681","Zeva","F","19","24",43
"6685","Zurisadai","F","19","24",43
"6778","Emalie","F","18","25",43
"6787","Ezmeralda","F","18","25",43
"6819","Joplin","F","18","25",43
"6856","Maelle","F","18","25",43
"6896","Rani","F","18","25",43
"6922","Tensley","F","18","25",43
"7023","Dima","F","17","26",43
"7120","Makinzie","F","17","26",43
"7159","Paw","F","17","26",43
"7192","Skarlette","F","17","26",43
"7413","Krystel","F","16","27",43
"7957","Zahria","F","15","28",43
"8173","Keilany","F","14","29",43
"8736","Ohana","F","13","30",43
"4589","Aunna","F","30","12",42
"4854","Avneet","F","28","14",42
"4940","Risha","F","28","14",42
"5061","Miarose","F","27","15",42
"5079","Rossy","F","27","15",42
"5096","Tiffani","F","27","15",42
"5100","Xylia","F","27","15",42
"5128","Auna","F","26","16",42
"5158","Florencia","F","26","16",42
"5186","Kassia","F","26","16",42
"5198","Khai","F","26","16",42
"5206","Maayan","F","26","16",42
"5209","Maelani","F","26","16",42
"5262","Tabatha","F","26","16",42
"5282","Apollonia","F","25","17",42
"5312","Damani","F","25","17",42
"5392","Myanna","F","25","17",42
"5397","Nixie","F","25","17",42
"5427","Ysabel","F","25","17",42
"5453","Alyzah","F","24","18",42
"5479","Camora","F","24","18",42
"5502","Ellagrace","F","24","18",42
"5504","Elynn","F","24","18",42
"5603","Payzlee","F","24","18",42
"5612","Saida","F","24","18",42
"5648","Anaira","F","23","19",42
"5725","Kashmir","F","23","19",42
"5730","Kelby","F","23","19",42
"5734","Lanya","F","23","19",42
"5753","Mckinzie","F","23","19",42
"5756","Meyah","F","23","19",42
"5779","Shaira","F","23","19",42
"5819","Albany","F","22","20",42
"5834","Ashely","F","22","20",42
"5836","Aubryn","F","22","20",42
"5892","January","F","22","20",42
"5896","Jaxon","F","22","20",42
"5912","Kamira","F","22","20",42
"5927","Lasya","F","22","20",42
"5933","Madisynn","F","22","20",42
"5934","Makyah","F","22","20",42
"5945","Mickayla","F","22","20",42
"5968","Patrice","F","22","20",42
"5971","Ramiah","F","22","20",42
"6007","Yulia","F","22","20",42
"6011","Zehra","F","22","20",42
"6077","Emersynn","F","21","21",42
"6101","Jazzmin","F","21","21",42
"6140","Maeli","F","21","21",42
"6170","Rama","F","21","21",42
"6174","Samina","F","21","21",42
"6195","Viridiana","F","21","21",42
"6196","Vivi","F","21","21",42
"6213","Aella","F","20","22",42
"6221","Allianna","F","20","22",42
"6285","Gisel","F","20","22",42
"6327","Kyliegh","F","20","22",42
"6358","Mera","F","20","22",42
"6416","Zoraya","F","20","22",42
"6428","Aide","F","19","23",42
"6489","Dariya","F","19","23",42
"6510","Freida","F","19","23",42
"6514","Giorgia","F","19","23",42
"6555","Kensey","F","19","23",42
"6595","Marsha","F","19","23",42
"6612","Nicolina","F","19","23",42
"6619","Paiton","F","19","23",42
"6623","Paytin","F","19","23",42
"6628","Preston","F","19","23",42
"6678","Zelena","F","19","23",42
"6765","Desi","F","18","24",42
"6800","Havanna","F","18","24",42
"6882","Niang","F","18","24",42
"6897","Rhonda","F","18","24",42
"6906","Sarafina","F","18","24",42
"7005","Charlise","F","17","25",42
"7014","Damaya","F","17","25",42
"7042","Gioia","F","17","25",42
"7199","Talaysia","F","17","25",42
"7204","Tamiah","F","17","25",42
"7273","Aolanis","F","16","26",42
"7320","Clarisse","F","16","26",42
"7366","Hazely","F","16","26",42
"7428","Lively","F","16","26",42
"7478","Onalee","F","16","26",42
"7631","Azara","F","15","27",42
"8953","Bexleigh","F","12","30",42
"12796","Louna","F","7","35",42
"4711","Adna","F","29","12",41
"4839","Alitzel","F","28","13",41
"5021","Hennessey","F","27","14",41
"5092","Sunjai","F","27","14",41
"5119","Analyn","F","26","15",41
"5150","Ely","F","26","15",41
"5151","Elyn","F","26","15",41
"5182","Kahli","F","26","15",41
"5208","Madigan","F","26","15",41
"5216","Maricella","F","26","15",41
"5293","Barrett","F","25","16",41
"5310","Daija","F","25","16",41
"5341","Inessa","F","25","16",41
"5358","Kelia","F","25","16",41
"5359","Kellen","F","25","16",41
"5382","Mana","F","25","16",41
"5390","Mitzi","F","25","16",41
"5443","Adya","F","24","17",41
"5484","Charliee","F","24","17",41
"5487","Damari","F","24","17",41
"5493","Demiya","F","24","17",41
"5536","Joanie","F","24","17",41
"5618","Teal","F","24","17",41
"5669","Caelynn","F","23","18",41
"5674","Catelynn","F","23","18",41
"5716","Jenika","F","23","18",41
"5772","Retal","F","23","18",41
"5784","Shruti","F","23","18",41
"5789","Sura","F","23","18",41
"5795","Verena","F","23","18",41
"5815","Aixa","F","22","19",41
"5835","Ashleen","F","22","19",41
"5846","Bryer","F","22","19",41
"5863","Eda","F","22","19",41
"5885","Inga","F","22","19",41
"5898","Jeanelle","F","22","19",41
"5960","Nayara","F","22","19",41
"5983","Shariah","F","22","19",41
"5993","Taina","F","22","19",41
"6001","Tylynn","F","22","19",41
"6009","Zalia","F","22","19",41
"6014","Zunaira","F","22","19",41
"6037","Ashlie","F","21","20",41
"6074","Elka","F","21","20",41
"6081","Evynn","F","21","20",41
"6090","Harleyquinn","F","21","20",41
"6104","Jolena","F","21","20",41
"6110","Kaileah","F","21","20",41
"6111","Kailin","F","21","20",41
"6137","Maddalynn","F","21","20",41
"6155","Mora","F","21","20",41
"6187","Tamaya","F","21","20",41
"6233","Anneli","F","20","21",41
"6243","Aveya","F","20","21",41
"6294","Isidora","F","20","21",41
"6303","Jenasis","F","20","21",41
"6307","Jory","F","20","21",41
"6340","Loralai","F","20","21",41
"6346","Makaya","F","20","21",41
"6371","Nicola","F","20","21",41
"6388","Saphire","F","20","21",41
"6401","Syniah","F","20","21",41
"6420","Aaron","F","19","22",41
"6431","Alaijah","F","19","22",41
"6466","Auset","F","19","22",41
"6469","Aviannah","F","19","22",41
"6471","Aziya","F","19","22",41
"6486","Corey","F","19","22",41
"6508","Fiora","F","19","22",41
"6518","Hasset","F","19","22",41
"6586","Mailey","F","19","22",41
"6645","Rubee","F","19","22",41
"6680","Zendayah","F","19","22",41
"6683","Zuleyma","F","19","22",41
"6699","Alleigh","F","18","23",41
"6708","Amilyah","F","18","23",41
"6740","Camiah","F","18","23",41
"6858","Malone","F","18","23",41
"6885","Nolan","F","18","23",41
"6891","Quinlee","F","18","23",41
"6892","Quinlyn","F","18","23",41
"6937","Yocelyn","F","18","23",41
"6941","Zanna","F","18","23",41
"6946","Abbigayle","F","17","24",41
"6955","Alania","F","17","24",41
"6971","Anina","F","17","24",41
"7097","Lakely","F","17","24",41
"7157","Oreoluwa","F","17","24",41
"7211","Tristen","F","17","24",41
"7219","Xoey","F","17","24",41
"7227","Zayley","F","17","24",41
"7298","Bela","F","16","25",41
"7316","Chizara","F","16","25",41
"7333","Dionna","F","16","25",41
"7340","Eleina","F","16","25",41
"7387","Jeniyah","F","16","25",41
"7394","Joycelyn","F","16","25",41
"7415","Kyanna","F","16","25",41
"7527","Sriya","F","16","25",41
"7538","Tinsleigh","F","16","25",41
"8289","Rayonna","F","14","27",41
"8379","Zamari","F","14","27",41
"8763","Ren","F","13","28",41
"8918","Arika","F","12","29",41
"8934","Ave","F","12","29",41
"9724","Lira","F","11","30",41
"4917","Maegan","F","28","12",40
"5081","Rynn","F","27","13",40
"5285","Ariyanah","F","25","15",40
"5291","Aylinn","F","25","15",40
"5305","Cheyann","F","25","15",40
"5366","Kloee","F","25","15",40
"5369","Kynadee","F","25","15",40
"5376","Lisandra","F","25","15",40
"5415","Sigrid","F","25","15",40
"5439","Adaeze","F","24","16",40
"5441","Adel","F","24","16",40
"5485","Cody","F","24","16",40
"5486","Cylie","F","24","16",40
"5494","Demya","F","24","16",40
"5500","Elie","F","24","16",40
"5506","Emmalia","F","24","16",40
"5521","Jaleigha","F","24","16",40
"5559","Kris","F","24","16",40
"5567","Lyncoln","F","24","16",40
"5570","Lynnix","F","24","16",40
"5583","Meghna","F","24","16",40
"5591","Navayah","F","24","16",40
"5594","Nelia","F","24","16",40
"5620","Tristin","F","24","16",40
"5624","Vivia","F","24","16",40
"5640","Ainslie","F","23","17",40
"5645","Amorette","F","23","17",40
"5675","Ceanna","F","23","17",40
"5688","Elisabet","F","23","17",40
"5703","Haylei","F","23","17",40
"5709","Iya","F","23","17",40
"5718","Jeylin","F","23","17",40
"5757","Michela","F","23","17",40
"5777","Sameeha","F","23","17",40
"5814","Aime","F","22","18",40
"5820","Alexander","F","22","18",40
"5833","Arria","F","22","18",40
"5844","Brinn","F","22","18",40
"5858","Daviana","F","22","18",40
"5882","Idaly","F","22","18",40
"5907","Kadiatou","F","22","18",40
"5937","Maleeya","F","22","18",40
"5946","Mikala","F","22","18",40
"5982","Shaniah","F","22","18",40
"6041","Briannah","F","21","19",40
"6052","Ciel","F","21","19",40
"6056","Cristiana","F","21","19",40
"6057","Cristy","F","21","19",40
"6079","Emrys","F","21","19",40
"6095","Isolde","F","21","19",40
"6100","Jasia","F","21","19",40
"6121","Kynli","F","21","19",40
"6129","Liam","F","21","19",40
"6134","Loveah","F","21","19",40
"6147","Mckenleigh","F","21","19",40
"6158","Nahia","F","21","19",40
"6161","Neda","F","21","19",40
"6164","Niharika","F","21","19",40
"6180","Shaya","F","21","19",40
"6200","Yocelin","F","21","19",40
"6205","Zayana","F","21","19",40
"6210","Adair","F","20","20",40
"6217","Alaila","F","20","20",40
"6241","Aryannah","F","20","20",40
"6244","Aviella","F","20","20",40
"6271","Emillia","F","20","20",40
"6278","Fatimata","F","20","20",40
"6279","Fawn","F","20","20",40
"6290","Haizlee","F","20","20",40
"6305","Jood","F","20","20",40
"6323","Keyara","F","20","20",40
"6382","Rayn","F","20","20",40
"6392","Sehaj","F","20","20",40
"6411","Zamiah","F","20","20",40
"6415","Zoella","F","20","20",40
"6422","Abbygale","F","19","21",40
"6432","Alaine","F","19","21",40
"6456","Araina","F","19","21",40
"6529","Jamirah","F","19","21",40
"6568","Lamaya","F","19","21",40
"6569","Landrey","F","19","21",40
"6585","Mahlia","F","19","21",40
"6587","Maizee","F","19","21",40
"6589","Malasia","F","19","21",40
"6597","Maybelline","F","19","21",40
"6615","Olivianna","F","19","21",40
"6630","Raneem","F","19","21",40
"6660","Shloka","F","19","21",40
"6688","Addalee","F","18","22",40
"6734","Breleigh","F","18","22",40
"6743","Caylen","F","18","22",40
"6755","Daniah","F","18","22",40
"6756","Daniel","F","18","22",40
"6801","Heavyn","F","18","22",40
"6836","Koryn","F","18","22",40
"6854","Maddi","F","18","22",40
"6865","Mccall","F","18","22",40
"6880","Nautica","F","18","22",40
"6881","Navaya","F","18","22",40
"6893","Raedyn","F","18","22",40
"6894","Raghad","F","18","22",40
"6909","Schuyler","F","18","22",40
"6933","Weslie","F","18","22",40
"6942","Zanyla","F","18","22",40
"6948","Adaia","F","17","23",40
"6954","Alaisha","F","17","23",40
"7051","Idy","F","17","23",40
"7088","Kennia","F","17","23",40
"7193","Sonali","F","17","23",40
"7307","Brogan","F","16","24",40
"7321","Codie","F","16","24",40
"7323","Coraleigh","F","16","24",40
"7500","Risa","F","16","24",40
"7513","Sayge","F","16","24",40
"7551","Yari","F","16","24",40
"7561","Zaylin","F","16","24",40
"7571","Abi","F","15","25",40
"7783","Kinza","F","15","25",40
"7794","Lianne","F","15","25",40
"7954","Yashika","F","15","25",40
"7979","Aitanna","F","14","26",40
"8382","Zanylah","F","14","26",40
"8553","Fajr","F","13","27",40
"4951","Shanty","F","28","11",39
"5125","Aubreyanna","F","26","13",39
"5164","Giabella","F","26","13",39
"5204","Lorali","F","26","13",39
"5309","Courtlynn","F","25","14",39
"5391","Miyanna","F","25","14",39
"5418","Sumaiya","F","25","14",39
"5507","Emoree","F","24","15",39
"5528","Jayliah","F","24","15",39
"5534","Jerzie","F","24","15",39
"5571","Mackinley","F","24","15",39
"5582","Mckenzee","F","24","15",39
"5588","Nakiya","F","24","15",39
"5596","Nikayla","F","24","15",39
"5619","Tressa","F","24","15",39
"5642","Alonah","F","23","16",39
"5643","Amariya","F","23","16",39
"5655","Ashby","F","23","16",39
"5702","Hartlyn","F","23","16",39
"5724","Karmella","F","23","16",39
"5726","Katheryne","F","23","16",39
"5732","Kynedi","F","23","16",39
"5743","Maeley","F","23","16",39
"5825","Angelise","F","22","17",39
"5841","Avital","F","22","17",39
"5880","Hinley","F","22","17",39
"5899","Jeilyn","F","22","17",39
"5908","Kaelee","F","22","17",39
"5917","Kattleya","F","22","17",39
"5950","Morgyn","F","22","17",39
"5953","Myriah","F","22","17",39
"5984","Sheily","F","22","17",39
"6012","Zoila","F","22","17",39
"6042","Britanny","F","21","18",39
"6062","Danylah","F","21","18",39
"6064","Dasani","F","21","18",39
"6069","Denym","F","21","18",39
"6084","Frimet","F","21","18",39
"6106","Joselyne","F","21","18",39
"6144","Matty","F","21","18",39
"6154","Milayah","F","21","18",39
"6186","Stevi","F","21","18",39
"6204","Zarianna","F","21","18",39
"6225","Amare","F","20","19",39
"6239","Ariyonna","F","20","19",39
"6248","Beaux","F","20","19",39
"6264","Dessa","F","20","19",39
"6276","Everlynn","F","20","19",39
"6286","Gracia","F","20","19",39
"6292","Heydi","F","20","19",39
"6301","Jaslin","F","20","19",39
"6304","Jenica","F","20","19",39
"6312","Kamirah","F","20","19",39
"6325","Kindle","F","20","19",39
"6336","Lelah","F","20","19",39
"6341","Lorenza","F","20","19",39
"6345","Maely","F","20","19",39
"6347","Malayla","F","20","19",39
"6352","Marymargaret","F","20","19",39
"6356","Meg","F","20","19",39
"6389","Sarena","F","20","19",39
"6438","Alorah","F","19","20",39
"6445","Amzie","F","19","20",39
"6447","Andriana","F","19","20",39
"6465","Aurelie","F","19","20",39
"6468","Avantika","F","19","20",39
"6475","Brocha","F","19","20",39
"6476","Callyn","F","19","20",39
"6507","Fionna","F","19","20",39
"6533","Jaynie","F","19","20",39
"6567","Laityn","F","19","20",39
"6570","Langston","F","19","20",39
"6576","Livian","F","19","20",39
"6578","Lucciana","F","19","20",39
"6580","Lyah","F","19","20",39
"6593","Marci","F","19","20",39
"6637","Rene","F","19","20",39
"6825","Keller","F","18","21",39
"6861","Marionna","F","18","21",39
"6863","Marya","F","18","21",39
"6879","Naudia","F","18","21",39
"6903","Sammy","F","18","21",39
"6987","Belladonna","F","17","22",39
"7018","Darielle","F","17","22",39
"7020","Dayton","F","17","22",39
"7033","Erykah","F","17","22",39
"7048","Harlei","F","17","22",39
"7093","Kory","F","17","22",39
"7122","Malaiya","F","17","22",39
"7141","Monzerrat","F","17","22",39
"7216","Vilma","F","17","22",39
"7341","Eleny","F","16","23",39
"7396","Kadija","F","16","23",39
"7418","Lamees","F","16","23",39
"7541","Truth","F","16","23",39
"7548","Wrenley","F","16","23",39
"7566","Zulay","F","16","23",39
"7707","Evelia","F","15","24",39
"7907","Shanya","F","15","24",39
"8012","Athziri","F","14","25",39
"8037","Brexley","F","14","25",39
"8042","Callaway","F","14","25",39
"8045","Camilah","F","14","25",39
"8162","Kamelia","F","14","25",39
"8174","Kelsee","F","14","25",39
"8310","Sereen","F","14","25",39
"8350","Tigerlily","F","14","25",39
"8575","Ilyanna","F","13","26",39
"8579","Iylah","F","13","26",39
"8708","Milo","F","13","26",39
"8710","Mirian","F","13","26",39
"8761","Rei","F","13","26",39
"8765","Rhemi","F","13","26",39
"8830","Wrenn","F","13","26",39
"9044","Germany","F","12","27",39
"9112","Kamrie","F","12","27",39
"9994","Aleksa","F","10","29",39
"12142","Solene","F","8","31",39
"4567","Yazleemar","F","31","7",38
"4760","Janasia","F","29","9",38
"5210","Maesyn","F","26","12",38
"5274","Alissandra","F","25","13",38
"5315","Darcie","F","25","13",38
"5396","Nevaya","F","25","13",38
"5465","Arshiya","F","24","14",38
"5480","Caralyn","F","24","14",38
"5491","Darian","F","24","14",38
"5538","Jocelynne","F","24","14",38
"5548","Karlei","F","24","14",38
"5575","Makenley","F","24","14",38
"5633","Zarya","F","24","14",38
"5651","Andreya","F","23","15",38
"5656","Ashland","F","23","15",38
"5668","Brylin","F","23","15",38
"5678","Corbyn","F","23","15",38
"5720","Jurni","F","23","15",38
"5727","Kaybree","F","23","15",38
"5786","Simra","F","23","15",38
"5808","Abrie","F","22","16",38
"5849","Cataleyah","F","22","16",38
"5856","Danilynn","F","22","16",38
"5889","Izabellah","F","22","16",38
"5897","Jaylianna","F","22","16",38
"5936","Malayshia","F","22","16",38
"5956","Nalaya","F","22","16",38
"6006","Yoana","F","22","16",38
"6032","Arcadia","F","21","17",38
"6044","Caden","F","21","17",38
"6072","Dyllan","F","21","17",38
"6075","Ellanore","F","21","17",38
"6115","Kensli","F","21","17",38
"6117","Khamari","F","21","17",38
"6118","Kimbella","F","21","17",38
"6133","Londen","F","21","17",38
"6136","Madai","F","21","17",38
"6146","Mayumi","F","21","17",38
"6153","Michayla","F","21","17",38
"6157","Mylani","F","21","17",38
"6167","Nuria","F","21","17",38
"6173","Roseanna","F","21","17",38
"6175","Samone","F","21","17",38
"6198","Yanelis","F","21","17",38
"6253","Brayley","F","20","18",38
"6293","Ishana","F","20","18",38
"6315","Kashlynn","F","20","18",38
"6317","Katherina","F","20","18",38
"6322","Kenzee","F","20","18",38
"6335","Leeba","F","20","18",38
"6339","Logyn","F","20","18",38
"6377","Oliver","F","20","18",38
"6393","Shantal","F","20","18",38
"6397","Shilo","F","20","18",38
"6398","Sneha","F","20","18",38
"6400","Swayzee","F","20","18",38
"6402","Tarah","F","20","18",38
"6429","Ailene","F","19","19",38
"6444","Amirrah","F","19","19",38
"6461","Arisa","F","19","19",38
"6462","Aryel","F","19","19",38
"6470","Azalee","F","19","19",38
"6474","Brielynn","F","19","19",38
"6481","Charlei","F","19","19",38
"6496","Elnora","F","19","19",38
"6499","Emmajean","F","19","19",38
"6502","England","F","19","19",38
"6504","Evi","F","19","19",38
"6524","Isabeau","F","19","19",38
"6539","Julieann","F","19","19",38
"6545","Kalyssa","F","19","19",38
"6559","Korey","F","19","19",38
"6572","Lashay","F","19","19",38
"6574","Leyton","F","19","19",38
"6625","Peace","F","19","19",38
"6634","Remmie","F","19","19",38
"6640","Rhylan","F","19","19",38
"6671","Vedika","F","19","19",38
"6694","Ahria","F","18","20",38
"6784","Esmay","F","18","20",38
"6814","Jazzmyn","F","18","20",38
"6817","Jody","F","18","20",38
"6841","Laycie","F","18","20",38
"6867","Mckinsey","F","18","20",38
"6888","Penina","F","18","20",38
"6901","Sahra","F","18","20",38
"6943","Zuriah","F","18","20",38
"6952","Addylin","F","17","21",38
"6965","Amarra","F","17","21",38
"6977","Astraea","F","17","21",38
"7071","Jersie","F","17","21",38
"7086","Kemari","F","17","21",38
"7092","Koda","F","17","21",38
"7153","Nydia","F","17","21",38
"7162","Racheal","F","17","21",38
"7171","Reygan","F","17","21",38
"7175","Roseline","F","17","21",38
"7196","Suzannah","F","17","21",38
"7202","Talulah","F","17","21",38
"7207","Tayleigh","F","17","21",38
"7267","Anaia","F","16","22",38
"7295","Basil","F","16","22",38
"7309","Caiden","F","16","22",38
"7378","Jaileen","F","16","22",38
"7385","Jelani","F","16","22",38
"7467","Naylea","F","16","22",38
"7523","Skyelynn","F","16","22",38
"7646","Brecklynn","F","15","23",38
"7664","Celene","F","15","23",38
"7667","Chrystal","F","15","23",38
"7718","Harvest","F","15","23",38
"7723","Hira","F","15","23",38
"7726","Ioanna","F","15","23",38
"7812","Maila","F","15","23",38
"7839","Minnah","F","15","23",38
"7877","Rea","F","15","23",38
"7914","Sloka","F","15","23",38
"8027","Batool","F","14","24",38
"8099","Esra","F","14","24",38
"8231","Malaiyah","F","14","24",38
"8304","Safina","F","14","24",38
"8364","Vaughn","F","14","24",38
"8399","Abisai","F","13","25",38
"5177","Jenicka","F","26","11",37
"5239","Odalis","F","26","11",37
"5259","Surah","F","26","11",37
"5325","Erma","F","25","12",37
"5389","Misa","F","25","12",37
"5468","Ayrabella","F","24","13",37
"5513","Hasini","F","24","13",37
"5530","Jazell","F","24","13",37
"5540","Jozlynn","F","24","13",37
"5550","Katiana","F","24","13",37
"5555","Kennidy","F","24","13",37
"5597","Nirvi","F","24","13",37
"5635","Aalyah","F","23","14",37
"5638","Adreanna","F","23","14",37
"5647","Anabela","F","23","14",37
"5654","Aryianna","F","23","14",37
"5672","Camri","F","23","14",37
"5690","Elleanna","F","23","14",37
"5738","Lelani","F","23","14",37
"5740","Lielle","F","23","14",37
"5783","Shirin","F","23","14",37
"5828","Arieana","F","22","15",37
"5878","Hazelgrace","F","22","15",37
"5903","Jorden","F","22","15",37
"5904","Julyssa","F","22","15",37
"5932","Madalena","F","22","15",37
"5947","Milanie","F","22","15",37
"5959","Navia","F","22","15",37
"5977","Safari","F","22","15",37
"5989","Spring","F","22","15",37
"6013","Zuly","F","22","15",37
"6016","Ahmiyah","F","21","16",37
"6019","Akila","F","21","16",37
"6039","Bellamarie","F","21","16",37
"6046","Camile","F","21","16",37
"6049","Cathleen","F","21","16",37
"6059","Dailynn","F","21","16",37
"6061","Daleyssa","F","21","16",37
"6096","Ivelisse","F","21","16",37
"6120","Kyndle","F","21","16",37
"6141","Majesti","F","21","16",37
"6151","Mekenzie","F","21","16",37
"6159","Naziyah","F","21","16",37
"6163","Nicol","F","21","16",37
"6166","Norie","F","21","16",37
"6171","Rayyan","F","21","16",37
"6222","Allure","F","20","17",37
"6255","Bryley","F","20","17",37
"6260","Daphnie","F","20","17",37
"6262","Delaina","F","20","17",37
"6299","Jalina","F","20","17",37
"6300","Jaliya","F","20","17",37
"6308","Josi","F","20","17",37
"6309","Joss","F","20","17",37
"6310","Jovana","F","20","17",37
"6313","Karliah","F","20","17",37
"6361","Mikeyla","F","20","17",37
"6365","Moksha","F","20","17",37
"6395","Shelbi","F","20","17",37
"6407","Yakira","F","20","17",37
"6413","Zanyiah","F","20","17",37
"6446","Anahita","F","19","18",37
"6448","Anely","F","19","18",37
"6517","Harmoney","F","19","18",37
"6520","Holiday","F","19","18",37
"6607","Muntaha","F","19","18",37
"6616","Oluwatamilore","F","19","18",37
"6621","Paizleigh","F","19","18",37
"6627","Pihu","F","19","18",37
"6633","Reghan","F","19","18",37
"6646","Rumaysa","F","19","18",37
"6648","Sadi","F","19","18",37
"6669","Teryn","F","19","18",37
"6674","Yarielis","F","19","18",37
"6690","Aeliana","F","18","19",37
"6696","Akirah","F","18","19",37
"6698","Alizon","F","18","19",37
"6718","Anzal","F","18","19",37
"6724","Ayaat","F","18","19",37
"6747","Chioma","F","18","19",37
"6792","Graceann","F","18","19",37
"6823","Kashvi","F","18","19",37
"6826","Kemoni","F","18","19",37
"6834","Koi","F","18","19",37
"6843","Leeya","F","18","19",37
"6873","Milaya","F","18","19",37
"6915","Solomia","F","18","19",37
"7024","Dove","F","17","20",37
"7040","Frady","F","17","20",37
"7049","Harnoor","F","17","20",37
"7052","Ikhlas","F","17","20",37
"7053","Ilani","F","17","20",37
"7079","Kariyah","F","17","20",37
"7112","Lynnea","F","17","20",37
"7115","Mahealani","F","17","20",37
"7158","Page","F","17","20",37
"7180","Sayra","F","17","20",37
"7197","Suzy","F","17","20",37
"7198","Sylvi","F","17","20",37
"7214","Vella","F","17","20",37
"7231","Aayat","F","16","21",37
"7240","Adessa","F","16","21",37
"7269","Andersen","F","16","21",37
"7290","Avnoor","F","16","21",37
"7362","Graycee","F","16","21",37
"7363","Hailynn","F","16","21",37
"7368","Heavenleigh","F","16","21",37
"7382","Jamiracle","F","16","21",37
"7412","Klaudia","F","16","21",37
"7504","Sable","F","16","21",37
"7591","Alanys","F","15","22",37
"7732","Jamisyn","F","15","22",37
"7780","Kierstin","F","15","22",37
"7799","Loraine","F","15","22",37
"7800","Lorene","F","15","22",37
"7867","Qamar","F","15","22",37
"7888","Roselin","F","15","22",37
"7895","Ryliegh","F","15","22",37
"7931","Tasha","F","15","22",37
"7964","Zyah","F","15","22",37
"7984","Alianah","F","14","23",37
"8100","Farren","F","14","23",37
"8112","Hargun","F","14","23",37
"8234","Marilu","F","14","23",37
"8303","Sabreen","F","14","23",37
"8362","Tzivia","F","14","23",37
"8415","Airiana","F","13","24",37
"8622","Keerthana","F","13","24",37
"9030","Ethel","F","12","25",37
"9196","Mariaelena","F","12","25",37
"5252","Shilah","F","26","10",36
"5352","Jerzey","F","25","11",36
"5449","Aleesa","F","24","12",36
"5482","Catalia","F","24","12",36
"5520","Jalea","F","24","12",36
"5529","Jaynee","F","24","12",36
"5758","Milany","F","23","13",36
"5767","Payge","F","23","13",36
"5785","Shylee","F","23","13",36
"5810","Addalynne","F","22","14",36
"5816","Ala","F","22","14",36
"5817","Alabama","F","22","14",36
"5822","Anelise","F","22","14",36
"5823","Angelee","F","22","14",36
"5839","Avana","F","22","14",36
"5843","Benita","F","22","14",36
"5869","Emmily","F","22","14",36
"5890","Jacob","F","22","14",36
"5902","Jennyfer","F","22","14",36
"5905","Kadance","F","22","14",36
"5918","Kelci","F","22","14",36
"5920","Kollyns","F","22","14",36
"5944","Micha","F","22","14",36
"5949","Montgomery","F","22","14",36
"5951","Munachimso","F","22","14",36
"5958","Natilee","F","22","14",36
"5961","Nayelis","F","22","14",36
"5975","Rozalynn","F","22","14",36
"5980","Sanvika","F","22","14",36
"6005","Yaritzi","F","22","14",36
"6028","Anica","F","21","15",36
"6043","British","F","21","15",36
"6087","Graclyn","F","21","15",36
"6105","Jonnie","F","21","15",36
"6130","Liat","F","21","15",36
"6145","Mayli","F","21","15",36
"6183","Sofija","F","21","15",36
"6203","Zaleah","F","21","15",36
"6212","Adithi","F","20","16",36
"6224","Alydia","F","20","16",36
"6230","Angelin","F","20","16",36
"6232","Anneke","F","20","16",36
"6250","Blue","F","20","16",36
"6281","Galia","F","20","16",36
"6320","Keera","F","20","16",36
"6349","Marilee","F","20","16",36
"6353","Mattilynn","F","20","16",36
"6366","Nafisa","F","20","16",36
"6384","Rome","F","20","16",36
"6385","Rosey","F","20","16",36
"6418","Zuzu","F","20","16",36
"6423","Abigaile","F","19","17",36
"6437","Alisandra","F","19","17",36
"6450","Angelisa","F","19","17",36
"6535","Jessabelle","F","19","17",36
"6590","Manaia","F","19","17",36
"6620","Paitynn","F","19","17",36
"6624","Paytyn","F","19","17",36
"6641","Rielynn","F","19","17",36
"6670","Tylie","F","19","17",36
"6695","Aibhlinn","F","18","18",36
"6711","Anaise","F","18","18",36
"6714","Analeigha","F","18","18",36
"6746","Chayse","F","18","18",36
"6766","Destinie","F","18","18",36
"6821","Kariah","F","18","18",36
"6824","Katerin","F","18","18",36
"6837","Krysta","F","18","18",36
"6838","Kyley","F","18","18",36
"6855","Maddux","F","18","18",36
"6916","Taitum","F","18","18",36
"6936","Yemaya","F","18","18",36
"6976","Aspynn","F","17","19",36
"6992","Breslyn","F","17","19",36
"6993","Brieanna","F","17","19",36
"7041","Gabrianna","F","17","19",36
"7081","Kasie","F","17","19",36
"7108","Lovie","F","17","19",36
"7156","Ola","F","17","19",36
"7163","Radhika","F","17","19",36
"7229","Zosia","F","17","19",36
"7259","Amberley","F","16","20",36
"7284","Atalie","F","16","20",36
"7332","Dilara","F","16","20",36
"7346","Elona","F","16","20",36
"7389","Joli","F","16","20",36
"7432","Luanna","F","16","20",36
"7435","Lydiah","F","16","20",36
"7447","Malyah","F","16","20",36
"7468","Netanya","F","16","20",36
"7479","Orli","F","16","20",36
"7495","Reighlyn","F","16","20",36
"7552","Yeilin","F","16","20",36
"7581","Aden","F","15","21",36
"7587","Ahsha","F","15","21",36
"7616","Anorah","F","15","21",36
"7617","Anshika","F","15","21",36
"7632","Azrielle","F","15","21",36
"7684","Davi","F","15","21",36
"7687","Declynn","F","15","21",36
"7739","Jema","F","15","21",36
"7760","Kayleah","F","15","21",36
"7778","Kia","F","15","21",36
"7804","Lyrical","F","15","21",36
"7824","Marielena","F","15","21",36
"7848","Nakia","F","15","21",36
"7861","Pacey","F","15","21",36
"7890","Rosmery","F","15","21",36
"7958","Zain","F","15","21",36
"7967","Adalay","F","14","22",36
"8116","Honour","F","14","22",36
"8141","Jaye","F","14","22",36
"8290","Reba","F","14","22",36
"8296","Ronan","F","14","22",36
"8306","Sami","F","14","22",36
"8312","Shahad","F","14","22",36
"8402","Addi","F","13","23",36
"8535","Elayah","F","13","23",36
"8759","Rayleen","F","13","23",36
"8853","Adalida","F","12","24",36
"8925","Athina","F","12","24",36
"9160","Lennan","F","12","24",36
"9325","Turner","F","12","24",36
"9689","Kristell","F","11","25",36
"9714","Leydi","F","11","25",36
"10264","Kealani","F","10","26",36
"10768","Camya","F","9","27",36
"13556","Ilhan","F","6","30",36
"5374","Lesli","F","25","10",35
"5379","Makensie","F","25","10",35
"5470","Bethlehem","F","24","11",35
"5525","Jaxie","F","24","11",35
"5527","Jaydee","F","24","11",35
"5606","Reniyah","F","24","11",35
"5653","Arohi","F","23","12",35
"5708","Iveth","F","23","12",35
"5781","Sharanya","F","23","12",35
"5807","Aaralynn","F","22","13",35
"5809","Adaliz","F","22","13",35
"5837","Audry","F","22","13",35
"5850","Cayley","F","22","13",35
"5865","Ellana","F","22","13",35
"5866","Emanuela","F","22","13",35
"5870","Emrey","F","22","13",35
"5906","Kaden","F","22","13",35
"5915","Kathlyn","F","22","13",35
"5916","Katlynn","F","22","13",35
"5921","Koralyn","F","22","13",35
"5925","Laelynn","F","22","13",35
"5965","Olena","F","22","13",35
"6021","Aleiya","F","21","14",35
"6029","Annaleise","F","21","14",35
"6035","Arella","F","21","14",35
"6089","Hadli","F","21","14",35
"6091","Heer","F","21","14",35
"6168","Nyleah","F","21","14",35
"6185","Sophiagrace","F","21","14",35
"6188","Tayana","F","21","14",35
"6190","Torrie","F","21","14",35
"6218","Alayjah","F","20","15",35
"6219","Alima","F","20","15",35
"6242","Avalynne","F","20","15",35
"6249","Bina","F","20","15",35
"6257","Camillia","F","20","15",35
"6265","Destin","F","20","15",35
"6268","Dionne","F","20","15",35
"6273","Enid","F","20","15",35
"6288","Gracynn","F","20","15",35
"6311","Kally","F","20","15",35
"6338","Linsey","F","20","15",35
"6348","Marcie","F","20","15",35
"6359","Merrick","F","20","15",35
"6360","Miasia","F","20","15",35
"6391","Sebastian","F","20","15",35
"6425","Aditri","F","19","16",35
"6458","Ariabella","F","19","16",35
"6522","Honora","F","19","16",35
"6537","Jonae","F","19","16",35
"6546","Kamil","F","19","16",35
"6551","Kasyn","F","19","16",35
"6557","Klaira","F","19","16",35
"6566","Kyrielle","F","19","16",35
"6611","Nichelle","F","19","16",35
"6647","Sabrin","F","19","16",35
"6650","Sanah","F","19","16",35
"6651","Sarita","F","19","16",35
"6656","Sham","F","19","16",35
"6665","Starlynn","F","19","16",35
"6672","Yaquelin","F","19","16",35
"6693","Ahava","F","18","17",35
"6697","Alis","F","18","17",35
"6703","Alyona","F","18","17",35
"6732","Bluma","F","18","17",35
"6735","Brelyn","F","18","17",35
"6739","Brylei","F","18","17",35
"6753","Daisey","F","18","17",35
"6757","Dareen","F","18","17",35
"6762","Delayla","F","18","17",35
"6773","Elan","F","18","17",35
"6774","Eleonore","F","18","17",35
"6779","Emeree","F","18","17",35
"6783","Enaya","F","18","17",35
"6794","Greysen","F","18","17",35
"6799","Harlo","F","18","17",35
"6805","Isaiah","F","18","17",35
"6807","Jaaliyah","F","18","17",35
"6815","Jerzi","F","18","17",35
"6828","Khiara","F","18","17",35
"6829","Kiani","F","18","17",35
"6869","Meerab","F","18","17",35
"6889","Perrin","F","18","17",35
"6900","Ryelle","F","18","17",35
"6908","Savi","F","18","17",35
"6913","Shevy","F","18","17",35
"6957","Alethia","F","17","18",35
"6972","Annalina","F","17","18",35
"7002","Carlene","F","17","18",35
"7032","Endia","F","17","18",35
"7038","Farryn","F","17","18",35
"7064","Jaretzi","F","17","18",35
"7072","Joshua","F","17","18",35
"7083","Kattaleya","F","17","18",35
"7085","Kaziah","F","17","18",35
"7101","Leyana","F","17","18",35
"7102","Liel","F","17","18",35
"7116","Maheen","F","17","18",35
"7119","Makinsley","F","17","18",35
"7123","Malayiah","F","17","18",35
"7137","Mihira","F","17","18",35
"7148","Nayleen","F","17","18",35
"7182","Serra","F","17","18",35
"7200","Talea","F","17","18",35
"7205","Tatyanna","F","17","18",35
"7213","Vasiliki","F","17","18",35
"7268","Analeia","F","16","19",35
"7283","Astoria","F","16","19",35
"7310","Cammie","F","16","19",35
"7355","Eyla","F","16","19",35
"7357","Faelyn","F","16","19",35
"7375","Iza","F","16","19",35
"7416","Kylinn","F","16","19",35
"7424","Leyanna","F","16","19",35
"7464","Mysha","F","16","19",35
"7525","Sonam","F","16","19",35
"7555","Zaia","F","16","19",35
"7600","Almira","F","15","20",35
"7644","Brayden","F","15","20",35
"7650","Brielyn","F","15","20",35
"7653","Bryna","F","15","20",35
"7685","Davida","F","15","20",35
"7713","Gail","F","15","20",35
"7720","Hayzlee","F","15","20",35
"7751","Kaizlee","F","15","20",35
"7766","Keirah","F","15","20",35
"7782","Kimiko","F","15","20",35
"7787","Laekyn","F","15","20",35
"7814","Maisley","F","15","20",35
"7823","Manahil","F","15","20",35
"7856","Noya","F","15","20",35
"7916","Sophiya","F","15","20",35
"8009","Arietta","F","14","21",35
"8015","Avaleen","F","14","21",35
"8153","Jourdan","F","14","21",35
"8163","Kanyla","F","14","21",35
"8170","Kaylor","F","14","21",35
"8205","Larisa","F","14","21",35
"8238","Masha","F","14","21",35
"8244","Meyer","F","14","21",35
"8256","Nairobi","F","14","21",35
"8259","Nani","F","14","21",35
"8269","Nimrat","F","14","21",35
"8277","Oluwanifemi","F","14","21",35
"8354","Tobin","F","14","21",35
"8386","Zeniah","F","14","21",35
"8481","Brazil","F","13","22",35
"8508","Damiana","F","13","22",35
"8672","Macklyn","F","13","22",35
"8816","Teagyn","F","13","22",35
"8825","Ulani","F","13","22",35
"8829","Wesleigh","F","13","22",35
"8837","Yumna","F","13","22",35
"8886","Aleysha","F","12","23",35
"9062","Hiyab","F","12","23",35
"9064","Inari","F","12","23",35
"9121","Kathya","F","12","23",35
"9427","Asuna","F","11","24",35
"9481","Celestia","F","11","24",35
"9954","Zailyn","F","11","24",35
"10651","Alysse","F","9","26",35
"10683","Annaclaire","F","9","26",35
"5278","Amerika","F","25","9",34
"5543","Kaidance","F","24","10",34
"5639","Afia","F","23","11",34
"5692","Elyzabeth","F","23","11",34
"5715","Jenai","F","23","11",34
"5827","Annalynne","F","22","12",34
"5830","Arlen","F","22","12",34
"5886","Isabellah","F","22","12",34
"5943","Miana","F","22","12",34
"6018","Aizlynn","F","21","13",34
"6051","Christin","F","21","13",34
"6068","Deliyah","F","21","13",34
"6098","Jamyia","F","21","13",34
"6122","Kyria","F","21","13",34
"6125","Latoya","F","21","13",34
"6127","Layni","F","21","13",34
"6135","Lyna","F","21","13",34
"6169","Prestyn","F","21","13",34
"6179","Shamira","F","21","13",34
"6226","Ameyah","F","20","14",34
"6231","Anishka","F","20","14",34
"6266","Destyni","F","20","14",34
"6270","Emelin","F","20","14",34
"6302","Jeana","F","20","14",34
"6331","Lachlyn","F","20","14",34
"6332","Laisha","F","20","14",34
"6350","Marlaysia","F","20","14",34
"6379","Pierce","F","20","14",34
"6383","Riyana","F","20","14",34
"6399","Sofiah","F","20","14",34
"6427","Ahmya","F","19","15",34
"6440","Alyviah","F","19","15",34
"6477","Carolena","F","19","15",34
"6482","Charlye","F","19","15",34
"6485","Consuelo","F","19","15",34
"6490","Deandra","F","19","15",34
"6505","Evita","F","19","15",34
"6525","Ishita","F","19","15",34
"6526","Ivorie","F","19","15",34
"6560","Kortney","F","19","15",34
"6609","Nela","F","19","15",34
"6632","Raylinn","F","19","15",34
"6639","Retaj","F","19","15",34
"6655","Shakayla","F","19","15",34
"6666","Sylvana","F","19","15",34
"6679","Zenaya","F","19","15",34
"6722","Asmi","F","18","16",34
"6726","Aza","F","18","16",34
"6728","Azelie","F","18","16",34
"6795","Gwynevere","F","18","16",34
"6798","Hannia","F","18","16",34
"6811","Jaselyn","F","18","16",34
"6827","Kemya","F","18","16",34
"6842","Layonna","F","18","16",34
"6846","Leiyah","F","18","16",34
"6852","Lynelle","F","18","16",34
"6866","Mckenlee","F","18","16",34
"6870","Megha","F","18","16",34
"6884","Noely","F","18","16",34
"6887","Paisyn","F","18","16",34
"6925","Torah","F","18","16",34
"6947","Abigaelle","F","17","17",34
"6978","Atziry","F","17","17",34
"6983","Aylene","F","17","17",34
"6995","Brynlea","F","17","17",34
"7019","Davie","F","17","17",34
"7025","Dunya","F","17","17",34
"7073","Josseline","F","17","17",34
"7077","Kaja","F","17","17",34
"7082","Katalia","F","17","17",34
"7084","Kaydin","F","17","17",34
"7089","Kherington","F","17","17",34
"7090","Kinzey","F","17","17",34
"7099","Lawren","F","17","17",34
"7124","Maraya","F","17","17",34
"7126","Marleen","F","17","17",34
"7147","Nayana","F","17","17",34
"7150","Nelle","F","17","17",34
"7161","Purity","F","17","17",34
"7185","Shane","F","17","17",34
"7225","Zakia","F","17","17",34
"7282","Asra","F","16","18",34
"7360","Fraida","F","16","18",34
"7395","Julina","F","16","18",34
"7403","Keidy","F","16","18",34
"7488","Railee","F","16","18",34
"7503","Rossi","F","16","18",34
"7529","Swayzie","F","16","18",34
"7574","Abria","F","15","19",34
"7592","Alayza","F","15","19",34
"7597","Alin","F","15","19",34
"7639","Bonita","F","15","19",34
"7683","Darleen","F","15","19",34
"7695","Dyanna","F","15","19",34
"7697","Elleana","F","15","19",34
"7756","Kamyiah","F","15","19",34
"7826","Marybeth","F","15","19",34
"7849","Naliah","F","15","19",34
"7865","Peyten","F","15","19",34
"7912","Shylynn","F","15","19",34
"7918","Soriah","F","15","19",34
"7927","Taisley","F","15","19",34
"7938","Timberly","F","15","19",34
"7948","William","F","15","19",34
"8013","Aubryana","F","14","20",34
"8066","Danay","F","14","20",34
"8158","Kailei","F","14","20",34
"8175","Kenda","F","14","20",34
"8177","Kenzli","F","14","20",34
"8191","Koralynn","F","14","20",34
"8204","Lareina","F","14","20",34
"8242","Meriam","F","14","20",34
"8260","Nariya","F","14","20",34
"8292","Reighlynn","F","14","20",34
"8341","Tamryn","F","14","20",34
"8385","Zeenat","F","14","20",34
"8403","Adeena","F","13","21",34
"8478","Beretta","F","13","21",34
"8520","Dhiya","F","13","21",34
"8720","Naryah","F","13","21",34
"8793","Sharlotte","F","13","21",34
"8841","Zareen","F","13","21",34
"8895","Amayiah","F","12","22",34
"9202","Maryrose","F","12","22",34
"9335","Waylon","F","12","22",34
"9342","Yeva","F","12","22",34
"9796","Nihal","F","11","23",34
"9948","Yousra","F","11","23",34
"11169","Minahil","F","9","25",34
"11235","Rhilynn","F","9","25",34
"11674","Gelila","F","8","26",34
"11872","Lemon","F","8","26",34
"15095","Setareh","F","5","29",34
"5345","Jami","F","25","8",33
"5448","Alayshia","F","24","9",33
"5770","Rayaan","F","23","10",33
"5939","Manreet","F","22","11",33
"6022","Allyn","F","21","12",33
"6040","Bergen","F","21","12",33
"6099","Janiylah","F","21","12",33
"6131","Lillyonna","F","21","12",33
"6228","Analyse","F","20","13",33
"6237","Anyia","F","20","13",33
"6267","Deyanira","F","20","13",33
"6272","Emya","F","20","13",33
"6280","Febe","F","20","13",33
"6283","Giannah","F","20","13",33
"6354","Mccartney","F","20","13",33
"6355","Mckennah","F","20","13",33
"6381","Raigen","F","20","13",33
"6394","Shealynn","F","20","13",33
"6412","Zamzam","F","20","13",33
"6426","Adiya","F","19","14",33
"6430","Aiyanah","F","19","14",33
"6454","Annia","F","19","14",33
"6463","Aubryanna","F","19","14",33
"6506","Eymi","F","19","14",33
"6509","Frankee","F","19","14",33
"6521","Holli","F","19","14",33
"6534","Jennings","F","19","14",33
"6543","Kalilah","F","19","14",33
"6558","Kooper","F","19","14",33
"6581","Lynnex","F","19","14",33
"6594","Margie","F","19","14",33
"6622","Payslie","F","19","14",33
"6642","Rifky","F","19","14",33
"6649","Sakari","F","19","14",33
"6663","Sophina","F","19","14",33
"6667","Taliana","F","19","14",33
"6673","Yarelis","F","19","14",33
"6677","Zayden","F","19","14",33
"6736","Brena","F","18","15",33
"6745","Charmaine","F","18","15",33
"6769","Devi","F","18","15",33
"6772","Eeva","F","18","15",33
"6775","Eliane","F","18","15",33
"6776","Elika","F","18","15",33
"6797","Hanley","F","18","15",33
"6839","Kynzlie","F","18","15",33
"6844","Leightyn","F","18","15",33
"6847","Lexia","F","18","15",33
"6857","Malaiah","F","18","15",33
"6874","Miroslava","F","18","15",33
"6875","Miryam","F","18","15",33
"6902","Saiya","F","18","15",33
"6914","Sireen","F","18","15",33
"6919","Taniah","F","18","15",33
"6930","Ulyana","F","18","15",33
"6944","Aalani","F","17","16",33
"6961","Alisyn","F","17","16",33
"6966","Ambree","F","17","16",33
"6990","Blayne","F","17","16",33
"6996","Brynlynn","F","17","16",33
"7009","Contessa","F","17","16",33
"7034","Evaleigh","F","17","16",33
"7044","Golden","F","17","16",33
"7055","Iniya","F","17","16",33
"7057","Itzia","F","17","16",33
"7067","Jazlyne","F","17","16",33
"7078","Kamyia","F","17","16",33
"7091","Kiyanna","F","17","16",33
"7098","Lamiah","F","17","16",33
"7106","Lona","F","17","16",33
"7107","Lorin","F","17","16",33
"7114","Maebel","F","17","16",33
"7127","Marlin","F","17","16",33
"7136","Miaa","F","17","16",33
"7146","Naveen","F","17","16",33
"7168","Remmington","F","17","16",33
"7173","Rosaleen","F","17","16",33
"7176","Ruthanne","F","17","16",33
"7194","Sophi","F","17","16",33
"7203","Talyah","F","17","16",33
"7209","Tiyana","F","17","16",33
"7222","Yliana","F","17","16",33
"7239","Adelita","F","16","17",33
"7243","Aidana","F","16","17",33
"7245","Airianna","F","16","17",33
"7260","Ambrosia","F","16","17",33
"7279","Arlynn","F","16","17",33
"7314","Chaitra","F","16","17",33
"7374","Iyanah","F","16","17",33
"7380","Jameela","F","16","17",33
"7381","Jamielynn","F","16","17",33
"7393","Josefine","F","16","17",33
"7449","Maude","F","16","17",33
"7459","Misk","F","16","17",33
"7462","Myangel","F","16","17",33
"7470","Nikola","F","16","17",33
"7481","Paislyn","F","16","17",33
"7486","Ragan","F","16","17",33
"7487","Rahmah","F","16","17",33
"7514","Serenitee","F","16","17",33
"7515","Shaima","F","16","17",33
"7531","Tana","F","16","17",33
"7542","Tuesday","F","16","17",33
"7603","Amerah","F","15","18",33
"7621","Arna","F","15","18",33
"7629","Ayannah","F","15","18",33
"7657","Calypso","F","15","18",33
"7660","Carlina","F","15","18",33
"7673","Cole","F","15","18",33
"7768","Kella","F","15","18",33
"7806","Mabrey","F","15","18",33
"7838","Miliyah","F","15","18",33
"7858","Nyanna","F","15","18",33
"7902","Sejal","F","15","18",33
"7917","Sophy","F","15","18",33
"7942","Tsion","F","15","18",33
"7944","Tylia","F","15","18",33
"7949","Wrigley","F","15","18",33
"7992","Ameliarose","F","14","19",33
"8029","Betania","F","14","19",33
"8034","Blaine","F","14","19",33
"8056","Christabella","F","14","19",33
"8081","Dynver","F","14","19",33
"8084","Elaysia","F","14","19",33
"8087","Elexa","F","14","19",33
"8146","Jennessa","F","14","19",33
"8208","Leanora","F","14","19",33
"8226","Mahari","F","14","19",33
"8237","Marvel","F","14","19",33
"8388","Zeynab","F","14","19",33
"8390","Zivah","F","14","19",33
"8538","Ellenor","F","13","20",33
"8680","Malie","F","13","20",33
"8756","Prim","F","13","20",33
"8832","Yaelis","F","13","20",33
"8848","Aaima","F","12","21",33
"8893","Alyra","F","12","21",33
"8908","Angelly","F","12","21",33
"9070","Itzabella","F","12","21",33
"9073","Jaionna","F","12","21",33
"9131","Kenisha","F","12","21",33
"9282","Sanari","F","12","21",33
"9320","Toriana","F","12","21",33
"9458","Briany","F","11","22",33
"9563","Germani","F","11","22",33
"9694","Kymora","F","11","22",33
"9787","Nathali","F","11","22",33
"10164","Grier","F","10","23",33
"10175","Hayli","F","10","23",33
"10504","Shrinika","F","10","23",33
"10535","Teodora","F","10","23",33
"10950","Jaelynne","F","9","24",33
"11515","Bindi","F","8","25",33
"5637","Aarika","F","23","9",32
"5788","Sophiah","F","23","9",32
"5824","Angelena","F","22","10",32
"5994","Taiya","F","22","10",32
"6020","Aleigh","F","21","11",32
"6073","Elea","F","21","11",32
"6076","Ellouise","F","21","11",32
"6123","Lamyah","F","21","11",32
"6156","Mycah","F","21","11",32
"6176","Sanaii","F","21","11",32
"6178","Shalynn","F","21","11",32
"6181","Sindy","F","21","11",32
"6220","Alivea","F","20","12",32
"6227","Anala","F","20","12",32
"6234","Annsleigh","F","20","12",32
"6235","Anoushka","F","20","12",32
"6316","Kathalina","F","20","12",32
"6326","Kinze","F","20","12",32
"6378","Oriah","F","20","12",32
"6390","Saylah","F","20","12",32
"6404","Tynleigh","F","20","12",32
"6457","Areya","F","19","13",32
"6464","Audi","F","19","13",32
"6480","Caylynn","F","19","13",32
"6498","Embrie","F","19","13",32
"6500","Emmerie","F","19","13",32
"6531","Jariya","F","19","13",32
"6532","Jaylenne","F","19","13",32
"6571","Lania","F","19","13",32
"6610","Nhi","F","19","13",32
"6629","Raeanna","F","19","13",32
"6658","Shariyah","F","19","13",32
"6692","Agustina","F","18","14",32
"6725","Ayza","F","18","14",32
"6744","Chaney","F","18","14",32
"6750","Corbin","F","18","14",32
"6759","David","F","18","14",32
"6781","Emmaly","F","18","14",32
"6782","Emmalyne","F","18","14",32
"6785","Ethan","F","18","14",32
"6786","Evia","F","18","14",32
"6793","Greenley","F","18","14",32
"6810","Janaye","F","18","14",32
"6830","Kiona","F","18","14",32
"6835","Kolette","F","18","14",32
"6851","Lyndee","F","18","14",32
"6859","Manaal","F","18","14",32
"6868","Meaghan","F","18","14",32
"6883","Nikolina","F","18","14",32
"6904","Samreen","F","18","14",32
"6920","Taraoluwa","F","18","14",32
"6924","Tommi","F","18","14",32
"6932","Walker","F","18","14",32
"6935","Yarel","F","18","14",32
"6938","Ysabelle","F","18","14",32
"6958","Alexianna","F","17","15",32
"6967","Amel","F","17","15",32
"6982","Ayani","F","17","15",32
"7003","Catriona","F","17","15",32
"7007","Chassity","F","17","15",32
"7017","Darely","F","17","15",32
"7030","Ellsie","F","17","15",32
"7050","Hazyl","F","17","15",32
"7069","Jeniah","F","17","15",32
"7129","Mckinsley","F","17","15",32
"7132","Melek","F","17","15",32
"7152","Nolah","F","17","15",32
"7167","Reham","F","17","15",32
"7208","Teighan","F","17","15",32
"7212","Tyliyah","F","17","15",32
"7215","Viha","F","17","15",32
"7218","Xariah","F","17","15",32
"7223","Yuvia","F","17","15",32
"7242","Ahmani","F","16","16",32
"7251","Alden","F","16","16",32
"7252","Aleaha","F","16","16",32
"7264","Amirra","F","16","16",32
"7270","Andersyn","F","16","16",32
"7271","Anjana","F","16","16",32
"7276","Arayna","F","16","16",32
"7277","Ariely","F","16","16",32
"7293","Aysel","F","16","16",32
"7294","Azia","F","16","16",32
"7301","Brantlee","F","16","16",32
"7305","Brittan","F","16","16",32
"7311","Carlotta","F","16","16",32
"7315","Chelsi","F","16","16",32
"7326","Dahlila","F","16","16",32
"7335","Dyana","F","16","16",32
"7339","Elanna","F","16","16",32
"7348","Emmamarie","F","16","16",32
"7365","Hayle","F","16","16",32
"7408","Kharma","F","16","16",32
"7436","Madalynne","F","16","16",32
"7437","Maela","F","16","16",32
"7455","Memory","F","16","16",32
"7466","Navie","F","16","16",32
"7482","Patsy","F","16","16",32
"7489","Raileigh","F","16","16",32
"7530","Tai","F","16","16",32
"7535","Terriana","F","16","16",32
"7536","Tessla","F","16","16",32
"7537","Timberlynn","F","16","16",32
"7540","Traci","F","16","16",32
"7585","Ahmari","F","15","17",32
"7598","Aliz","F","15","17",32
"7607","Anah","F","15","17",32
"7612","Angella","F","15","17",32
"7622","Arrabella","F","15","17",32
"7628","Ayane","F","15","17",32
"7635","Bellamie","F","15","17",32
"7706","Evalena","F","15","17",32
"7715","Haasini","F","15","17",32
"7727","Ivori","F","15","17",32
"7742","Jonna","F","15","17",32
"7749","Juvia","F","15","17",32
"7759","Karishma","F","15","17",32
"7772","Keonna","F","15","17",32
"7801","Loriana","F","15","17",32
"7816","Makeyla","F","15","17",32
"7828","Mayrani","F","15","17",32
"7843","Mylan","F","15","17",32
"7852","Nethra","F","15","17",32
"7854","Nomi","F","15","17",32
"7892","Roza","F","15","17",32
"7926","Syrena","F","15","17",32
"7952","Yanna","F","15","17",32
"7997","Anaid","F","14","18",32
"8002","Anjelica","F","14","18",32
"8038","Briarrose","F","14","18",32
"8051","Chapel","F","14","18",32
"8052","Chenoa","F","14","18",32
"8058","Colbi","F","14","18",32
"8108","Haiven","F","14","18",32
"8144","Jazz","F","14","18",32
"8164","Karisa","F","14","18",32
"8196","Kylia","F","14","18",32
"8264","Nayra","F","14","18",32
"8278","Paz","F","14","18",32
"8370","Wania","F","14","18",32
"8391","Zo","F","14","18",32
"8468","Avonna","F","13","19",32
"8604","Jermany","F","13","19",32
"8629","Khamila","F","13","19",32
"8729","Neytiri","F","13","19",32
"8748","Peggy","F","13","19",32
"8774","Rylah","F","13","19",32
"8781","Samaiya","F","13","19",32
"8819","Tiya","F","13","19",32
"8966","Brucha","F","12","20",32
"9192","Malya","F","12","20",32
"9229","Nena","F","12","20",32
"9349","Zarielle","F","12","20",32
"9537","Ellarae","F","11","21",32
"9775","Mirra","F","11","21",32
"9883","Skyrah","F","11","21",32
"10005","Ameia","F","10","22",32
"10152","Flavia","F","10","22",32
"10401","Nadira","F","10","22",32
"13083","Tahani","F","7","25",32
"5338","Hayslee","F","25","6",31
"5684","Delayna","F","23","8",31
"5764","Nyree","F","23","8",31
"5832","Arora","F","22","9",31
"5909","Kailie","F","22","9",31
"5969","Pheobe","F","22","9",31
"6078","Emmalene","F","21","10",31
"6128","Lazaria","F","21","10",31
"6229","Anberlin","F","20","11",31
"6236","Anyelin","F","20","11",31
"6251","Brantleigh","F","20","11",31
"6259","Dalayah","F","20","11",31
"6328","Kyndel","F","20","11",31
"6434","Aleea","F","19","12",31
"6459","Ariell","F","19","12",31
"6460","Arielys","F","19","12",31
"6484","Cherie","F","19","12",31
"6503","Espyn","F","19","12",31
"6516","Han","F","19","12",31
"6527","Jahnavi","F","19","12",31
"6528","Jalayna","F","19","12",31
"6544","Kalin","F","19","12",31
"6549","Kanani","F","19","12",31
"6556","Kiri","F","19","12",31
"6575","Libbie","F","19","12",31
"6577","Lolita","F","19","12",31
"6588","Malanie","F","19","12",31
"6602","Melyssa","F","19","12",31
"6643","Roselle","F","19","12",31
"6664","Srinidhi","F","19","12",31
"6682","Ziyana","F","19","12",31
"6704","Amalya","F","18","13",31
"6706","Amela","F","18","13",31
"6713","Analea","F","18","13",31
"6721","Aryanah","F","18","13",31
"6738","Bruna","F","18","13",31
"6760","Daylee","F","18","13",31
"6777","Elsi","F","18","13",31
"6809","Jahniyah","F","18","13",31
"6818","Johnae","F","18","13",31
"6822","Kashmere","F","18","13",31
"6850","Lovelyn","F","18","13",31
"6895","Ramiya","F","18","13",31
"6907","Satya","F","18","13",31
"6923","Tilda","F","18","13",31
"6928","Tytiana","F","18","13",31
"6940","Zailah","F","18","13",31
"7000","Candelaria","F","17","14",31
"7011","Cyleigh","F","17","14",31
"7037","Evony","F","17","14",31
"7045","Gulianna","F","17","14",31
"7060","Jakiah","F","17","14",31
"7062","Jannatul","F","17","14",31
"7065","Jaritza","F","17","14",31
"7131","Melayna","F","17","14",31
"7133","Mellanie","F","17","14",31
"7170","Renesme","F","17","14",31
"7183","Shamari","F","17","14",31
"7186","Shanna","F","17","14",31
"7187","Shanzay","F","17","14",31
"7224","Zahari","F","17","14",31
"7233","Abrar","F","16","15",31
"7235","Abryanna","F","16","15",31
"7308","Cadance","F","16","15",31
"7317","Christyn","F","16","15",31
"7324","Corryn","F","16","15",31
"7338","Elainah","F","16","15",31
"7345","Ellayna","F","16","15",31
"7349","Emmely","F","16","15",31
"7351","Erionna","F","16","15",31
"7369","Humaira","F","16","15",31
"7372","Iriana","F","16","15",31
"7377","Jahniya","F","16","15",31
"7386","Jenaya","F","16","15",31
"7402","Keelin","F","16","15",31
"7410","Kimorah","F","16","15",31
"7417","Lachlan","F","16","15",31
"7423","Leola","F","16","15",31
"7429","Livianna","F","16","15",31
"7434","Luzelena","F","16","15",31
"7445","Malerie","F","16","15",31
"7484","Pharrah","F","16","15",31
"7494","Raynee","F","16","15",31
"7499","Rin","F","16","15",31
"7502","Roshni","F","16","15",31
"7521","Simi","F","16","15",31
"7554","Yuli","F","16","15",31
"7562","Zenovia","F","16","15",31
"7576","Adahlia","F","15","16",31
"7580","Adelai","F","15","16",31
"7594","Alesandra","F","15","16",31
"7623","Aryonna","F","15","16",31
"7641","Braelynne","F","15","16",31
"7654","Cabella","F","15","16",31
"7670","Claribel","F","15","16",31
"7671","Clark","F","15","16",31
"7702","Emunah","F","15","16",31
"7704","Estephanie","F","15","16",31
"7705","Estrellita","F","15","16",31
"7708","Eyleen","F","15","16",31
"7728","Izadora","F","15","16",31
"7730","Izzie","F","15","16",31
"7734","Jaydin","F","15","16",31
"7735","Jayley","F","15","16",31
"7744","Jordy","F","15","16",31
"7747","Julianny","F","15","16",31
"7774","Khaleah","F","15","16",31
"7803","Lynae","F","15","16",31
"7819","Makynna","F","15","16",31
"7821","Malaina","F","15","16",31
"7870","Raelle","F","15","16",31
"7873","Raphaella","F","15","16",31
"7891","Roux","F","15","16",31
"7920","Sreshta","F","15","16",31
"7933","Tenaya","F","15","16",31
"7970","Addilee","F","14","17",31
"7993","Amir","F","14","17",31
"8007","Areen","F","14","17",31
"8014","Augustina","F","14","17",31
"8104","Graelyn","F","14","17",31
"8132","Janeli","F","14","17",31
"8176","Kennidi","F","14","17",31
"8217","Lita","F","14","17",31
"8236","Marni","F","14","17",31
"8276","Oliviagrace","F","14","17",31
"8293","Reverie","F","14","17",31
"8299","Rosalin","F","14","17",31
"8301","Roxi","F","14","17",31
"8308","Saveah","F","14","17",31
"8332","Suttyn","F","14","17",31
"8345","Taylie","F","14","17",31
"8352","Toba","F","14","17",31
"8389","Zillah","F","14","17",31
"8395","Zully","F","14","17",31
"8442","Annaliah","F","13","18",31
"8446","Areesha","F","13","18",31
"8482","Breindy","F","13","18",31
"8505","Daleiza","F","13","18",31
"8513","Dekota","F","13","18",31
"8541","Elspeth","F","13","18",31
"8572","Ibtisam","F","13","18",31
"8601","Jeriah","F","13","18",31
"8648","Legacie","F","13","18",31
"8649","Leiloni","F","13","18",31
"8662","Lolah","F","13","18",31
"8709","Mirai","F","13","18",31
"8724","Nazaria","F","13","18",31
"8733","Noni","F","13","18",31
"8823","Troi","F","13","18",31
"8872","Airi","F","12","19",31
"8879","Alazne","F","12","19",31
"8888","Aliciana","F","12","19",31
"8947","Baya","F","12","19",31
"8968","Caiya","F","12","19",31
"9072","Ivyrose","F","12","19",31
"9100","Jream","F","12","19",31
"9102","Juliah","F","12","19",31
"9118","Kash","F","12","19",31
"9135","Kenslei","F","12","19",31
"9235","Nur","F","12","19",31
"9271","Rowena","F","12","19",31
"9299","Sibyl","F","12","19",31
"9338","Xara","F","12","19",31
"9382","Akyra","F","11","20",31
"9460","Brilyn","F","11","20",31
"9496","Cylee","F","11","20",31
"9545","Emiya","F","11","20",31
"9579","Hero","F","11","20",31
"9748","Mariann","F","11","20",31
"9881","Sina","F","11","20",31
"9950","Zadaya","F","11","20",31
"10072","Calyn","F","10","21",31
"10365","Mariamawit","F","10","21",31
"10456","Ray","F","10","21",31
"10575","Zakayla","F","10","21",31
"10687","Annelie","F","9","22",31
"10704","Arriah","F","9","22",31
"10863","Emmarae","F","9","22",31
"11132","Maleeah","F","9","22",31
"5894","Jaretssi","F","22","8",30
"5923","Krystiana","F","22","8",30
"5948","Mollee","F","22","8",30
"6036","Armonii","F","21","9",30
"6150","Meilany","F","21","9",30
"6298","Jalayla","F","20","10",30
"6330","Laasya","F","20","10",30
"6369","Nathania","F","20","10",30
"6376","Nyliah","F","20","10",30
"6436","Alexiah","F","19","11",30
"6452","Annebelle","F","19","11",30
"6453","Annelyse","F","19","11",30
"6455","Anum","F","19","11",30
"6488","Dalya","F","19","11",30
"6493","Destany","F","19","11",30
"6501","Emylee","F","19","11",30
"6513","Gimena","F","19","11",30
"6547","Kamree","F","19","11",30
"6554","Kennedee","F","19","11",30
"6601","Melis","F","19","11",30
"6614","Olivea","F","19","11",30
"6675","Yazlin","F","19","11",30
"6686","Aberdeen","F","18","12",30
"6687","Adaliah","F","18","12",30
"6712","Analaya","F","18","12",30
"6727","Azaylia","F","18","12",30
"6731","Benjamin","F","18","12",30
"6742","Cassi","F","18","12",30
"6754","Dally","F","18","12",30
"6780","Emireth","F","18","12",30
"6789","Gauri","F","18","12",30
"6806","Ivett","F","18","12",30
"6816","Jezelle","F","18","12",30
"6820","Kailana","F","18","12",30
"6833","Klover","F","18","12",30
"6862","Marlaina","F","18","12",30
"6871","Meztli","F","18","12",30
"6872","Mialynn","F","18","12",30
"6878","Nasra","F","18","12",30
"6912","Shaylie","F","18","12",30
"6918","Taleigha","F","18","12",30
"6929","Tzipporah","F","18","12",30
"6969","Ananda","F","17","13",30
"6981","Avy","F","17","13",30
"6998","Callia","F","17","13",30
"7015","Damiah","F","17","13",30
"7016","Dannia","F","17","13",30
"7035","Evangelyn","F","17","13",30
"7046","Haedyn","F","17","13",30
"7056","Ita","F","17","13",30
"7066","Jaylan","F","17","13",30
"7095","Kynzley","F","17","13",30
"7110","Lylia","F","17","13",30
"7130","Meili","F","17","13",30
"7143","Myonna","F","17","13",30
"7178","Samhita","F","17","13",30
"7195","Stephani","F","17","13",30
"7210","Torie","F","17","13",30
"7255","Alishba","F","16","14",30
"7286","Audriella","F","16","14",30
"7287","Aunesty","F","16","14",30
"7318","Chyann","F","16","14",30
"7322","Corabelle","F","16","14",30
"7325","Corynn","F","16","14",30
"7328","Davia","F","16","14",30
"7331","Desiray","F","16","14",30
"7334","Dusty","F","16","14",30
"7336","Edlyn","F","16","14",30
"7337","Eilee","F","16","14",30
"7344","Elizabelle","F","16","14",30
"7400","Katja","F","16","14",30
"7414","Krysten","F","16","14",30
"7438","Maeven","F","16","14",30
"7444","Maleeyah","F","16","14",30
"7450","Maybel","F","16","14",30
"7457","Miia","F","16","14",30
"7463","Mykaela","F","16","14",30
"7476","Nylee","F","16","14",30
"7522","Siyona","F","16","14",30
"7560","Zayanna","F","16","14",30
"7565","Zharia","F","16","14",30
"7573","Abri","F","15","15",30
"7596","Aliani","F","15","15",30
"7605","Amra","F","15","15",30
"7637","Binta","F","15","15",30
"7640","Bowen","F","15","15",30
"7652","Brooklyne","F","15","15",30
"7656","Callen","F","15","15",30
"7678","Dalaney","F","15","15",30
"7682","Danely","F","15","15",30
"7698","Elza","F","15","15",30
"7716","Hadiyah","F","15","15",30
"7776","Khamya","F","15","15",30
"7781","Kimari","F","15","15",30
"7790","Laylee","F","15","15",30
"7795","Lilley","F","15","15",30
"7811","Maevis","F","15","15",30
"7825","Marit","F","15","15",30
"7840","Mio","F","15","15",30
"7885","Ritaj","F","15","15",30
"7893","Ruhani","F","15","15",30
"7901","Seeley","F","15","15",30
"7919","Soriya","F","15","15",30
"7928","Tamira","F","15","15",30
"7943","Tvisha","F","15","15",30
"7963","Ziara","F","15","15",30
"7966","Aariya","F","14","16",30
"7980","Aithana","F","14","16",30
"7981","Ajwa","F","14","16",30
"7996","Amulya","F","14","16",30
"8017","Avanna","F","14","16",30
"8030","Bethania","F","14","16",30
"8031","Betzy","F","14","16",30
"8036","Bless","F","14","16",30
"8049","Catalyna","F","14","16",30
"8115","Hodan","F","14","16",30
"8122","Jaelene","F","14","16",30
"8123","Jailey","F","14","16",30
"8188","Knox","F","14","16",30
"8194","Krimson","F","14","16",30
"8201","Laiyla","F","14","16",30
"8252","Myrna","F","14","16",30
"8281","Perrie","F","14","16",30
"8307","Sarabeth","F","14","16",30
"8353","Tobi","F","14","16",30
"8355","Toleen","F","14","16",30
"8383","Zarai","F","14","16",30
"8384","Zarayah","F","14","16",30
"8449","Arista","F","13","17",30
"8452","Aryella","F","13","17",30
"8457","Aslyn","F","13","17",30
"8467","Aviela","F","13","17",30
"8469","Ayaana","F","13","17",30
"8479","Bibi","F","13","17",30
"8494","Camyla","F","13","17",30
"8533","Eilyn","F","13","17",30
"8562","Greenleigh","F","13","17",30
"8566","Hazell","F","13","17",30
"8631","Kimi","F","13","17",30
"8635","Kyna","F","13","17",30
"8643","Layani","F","13","17",30
"8650","Leira","F","13","17",30
"8654","Lilac","F","13","17",30
"8658","Lissandra","F","13","17",30
"8666","Lylian","F","13","17",30
"8713","Myles","F","13","17",30
"8714","Naava","F","13","17",30
"8731","Nisha","F","13","17",30
"8738","Oliviarose","F","13","17",30
"8741","Oriyah","F","13","17",30
"8766","Rifka","F","13","17",30
"8795","Shelley","F","13","17",30
"8801","Skilynn","F","13","17",30
"8933","Aurorah","F","12","18",30
"8955","Blaike","F","12","18",30
"8965","Brodie","F","12","18",30
"8975","Carmelina","F","12","18",30
"8996","Darlin","F","12","18",30
"9013","Efrata","F","12","18",30
"9040","Gaelle","F","12","18",30
"9063","Idalie","F","12","18",30
"9079","Jamey","F","12","18",30
"9093","Jeriyah","F","12","18",30
"9104","Junie","F","12","18",30
"9117","Karra","F","12","18",30
"9161","Lennyx","F","12","18",30
"9171","Loralye","F","12","18",30
"9183","Maggy","F","12","18",30
"9186","Mairin","F","12","18",30
"9199","Marita","F","12","18",30
"9221","Morgana","F","12","18",30
"9315","Thania","F","12","18",30
"9405","Anam","F","11","19",30
"9426","Astra","F","11","19",30
"9498","Daisie","F","11","19",30
"9538","Ellarie","F","11","19",30
"9542","Emerlyn","F","11","19",30
"9551","Evanee","F","11","19",30
"9560","Gemini","F","11","19",30
"9578","Henslee","F","11","19",30
"9613","Jeneva","F","11","19",30
"9644","Kana","F","11","19",30
"9773","Milli","F","11","19",30
"9840","Rhyann","F","11","19",30
"9911","Tessie","F","11","19",30
"9916","Valeska","F","11","19",30
"9937","Yamilex","F","11","19",30
"9949","Yuriana","F","11","19",30
"10585","Zeppelin","F","10","20",30
"10629","Aina","F","9","21",30
"10859","Emberley","F","9","21",30
"12241","Aamani","F","7","23",30
"12320","Annaleigha","F","7","23",30
"13564","Itzamara","F","6","24",30
"5868","Emmary","F","22","7",29
"6103","Jerilyn","F","21","8",29
"6149","Meeka","F","21","8",29
"6254","Breslin","F","20","9",29
"6277","Evolette","F","20","9",29
"6362","Millianna","F","20","9",29
"6410","Yesica","F","20","9",29
"6479","Caydance","F","19","10",29
"6495","Elda","F","19","10",29
"6511","Gavriella","F","19","10",29
"6515","Hagen","F","19","10",29
"6538","Judea","F","19","10",29
"6563","Kyasia","F","19","10",29
"6582","Mackenzee","F","19","10",29
"6591","Maniya","F","19","10",29
"6608","Mylia","F","19","10",29
"6676","Zaraya","F","19","10",29
"6701","Allysa","F","18","11",29
"6715","Anasia","F","18","11",29
"6730","Bayli","F","18","11",29
"6737","Brittani","F","18","11",29
"6761","Deeksha","F","18","11",29
"6771","Dominic","F","18","11",29
"6788","Gabriele","F","18","11",29
"6796","Haevyn","F","18","11",29
"6812","Jaylean","F","18","11",29
"6813","Jaziya","F","18","11",29
"6849","Lileigh","F","18","11",29
"6864","Mayvis","F","18","11",29
"6890","Pria","F","18","11",29
"6911","Shantell","F","18","11",29
"6917","Taj","F","18","11",29
"6927","Trinidy","F","18","11",29
"6979","Avina","F","17","12",29
"6980","Avrianna","F","17","12",29
"6984","Ayline","F","17","12",29
"6988","Berklie","F","17","12",29
"7004","Charla","F","17","12",29
"7006","Chasidy","F","17","12",29
"7010","Creedence","F","17","12",29
"7043","Gladis","F","17","12",29
"7047","Halee","F","17","12",29
"7061","Janina","F","17","12",29
"7100","Leiliana","F","17","12",29
"7121","Makynzi","F","17","12",29
"7125","Marifer","F","17","12",29
"7128","Maryclaire","F","17","12",29
"7134","Merary","F","17","12",29
"7135","Merryn","F","17","12",29
"7144","Nardos","F","17","12",29
"7154","Nysha","F","17","12",29
"7160","Presli","F","17","12",29
"7165","Reagen","F","17","12",29
"7169","Renad","F","17","12",29
"7174","Roselee","F","17","12",29
"7181","Sefora","F","17","12",29
"7201","Taleyah","F","17","12",29
"7234","Abriel","F","16","13",29
"7237","Adalei","F","16","13",29
"7248","Akshita","F","16","13",29
"7281","Ashtynn","F","16","13",29
"7291","Ayianna","F","16","13",29
"7299","Blaze","F","16","13",29
"7303","Brier","F","16","13",29
"7350","Epiphany","F","16","13",29
"7356","Fable","F","16","13",29
"7373","Isaura","F","16","13",29
"7388","Jentri","F","16","13",29
"7426","Lilybeth","F","16","13",29
"7430","Lorielle","F","16","13",29
"7440","Maisha","F","16","13",29
"7458","Milynn","F","16","13",29
"7465","Nasiyah","F","16","13",29
"7471","Nile","F","16","13",29
"7474","Nyala","F","16","13",29
"7492","Rashel","F","16","13",29
"7493","Rayanne","F","16","13",29
"7498","Rielyn","F","16","13",29
"7501","Rosaria","F","16","13",29
"7526","Sritha","F","16","13",29
"7547","Vincenza","F","16","13",29
"7558","Zaleigh","F","16","13",29
"7583","Adylin","F","15","14",29
"7601","Alyss","F","15","14",29
"7606","Anaeli","F","15","14",29
"7613","Annaka","F","15","14",29
"7619","Arielis","F","15","14",29
"7620","Armanii","F","15","14",29
"7648","Breezy","F","15","14",29
"7675","Connelly","F","15","14",29
"7694","Dominika","F","15","14",29
"7761","Kaylena","F","15","14",29
"7793","Leighana","F","15","14",29
"7797","Lincy","F","15","14",29
"7809","Madylin","F","15","14",29
"7810","Maebelle","F","15","14",29
"7869","Raeley","F","15","14",29
"7876","Rayhana","F","15","14",29
"7886","Robbie","F","15","14",29
"7887","Roselie","F","15","14",29
"7941","Tracie","F","15","14",29
"7959","Zakiah","F","15","14",29
"7960","Zamia","F","15","14",29
"7962","Zeriah","F","15","14",29
"7968","Adaleah","F","14","15",29
"8003","Annakate","F","14","15",29
"8006","Aqsa","F","14","15",29
"8023","Ayanah","F","14","15",29
"8032","Beulah","F","14","15",29
"8046","Carlisle","F","14","15",29
"8073","Denia","F","14","15",29
"8075","Devanny","F","14","15",29
"8083","Elainna","F","14","15",29
"8093","Emilianna","F","14","15",29
"8103","Ginevra","F","14","15",29
"8105","Graycie","F","14","15",29
"8110","Haleema","F","14","15",29
"8113","Haset","F","14","15",29
"8139","Jaxsyn","F","14","15",29
"8148","Jeslynn","F","14","15",29
"8171","Keani","F","14","15",29
"8190","Kody","F","14","15",29
"8192","Korrie","F","14","15",29
"8224","Lynnleigh","F","14","15",29
"8225","Madelina","F","14","15",29
"8245","Modesty","F","14","15",29
"8251","Myrical","F","14","15",29
"8265","Nayvie","F","14","15",29
"8270","Noe","F","14","15",29
"8279","Pennelope","F","14","15",29
"8291","Rebecka","F","14","15",29
"8295","Ritika","F","14","15",29
"8318","Shylo","F","14","15",29
"8342","Tamsyn","F","14","15",29
"8344","Tatiyana","F","14","15",29
"8348","Terryn","F","14","15",29
"8358","Tucker","F","14","15",29
"8375","Yalitza","F","14","15",29
"8381","Zanya","F","14","15",29
"8430","Ama","F","13","16",29
"8438","Anastyn","F","13","16",29
"8454","Asenath","F","13","16",29
"8473","Azarah","F","13","16",29
"8476","Azrael","F","13","16",29
"8488","Brinsley","F","13","16",29
"8534","Elany","F","13","16",29
"8545","Emmett","F","13","16",29
"8547","Eniola","F","13","16",29
"8559","Gissell","F","13","16",29
"8581","Jadeyn","F","13","16",29
"8589","Jakaylah","F","13","16",29
"8597","Jazmynn","F","13","16",29
"8602","Jerica","F","13","16",29
"8608","Jonelle","F","13","16",29
"8609","Joury","F","13","16",29
"8626","Keniya","F","13","16",29
"8628","Kesley","F","13","16",29
"8673","Madalin","F","13","16",29
"8677","Mahdiya","F","13","16",29
"8796","Sherri","F","13","16",29
"8821","Trany","F","13","16",29
"8878","Alayha","F","12","17",29
"8883","Aletta","F","12","17",29
"8889","Alicja","F","12","17",29
"8935","Avea","F","12","17",29
"8954","Bhavya","F","12","17",29
"8984","Cohen","F","12","17",29
"9009","Desteny","F","12","17",29
"9014","Elaf","F","12","17",29
"9113","Kamsiyochukwu","F","12","17",29
"9124","Keeleigh","F","12","17",29
"9169","Lisseth","F","12","17",29
"9181","Madolyn","F","12","17",29
"9184","Mahathi","F","12","17",29
"9217","Mikaya","F","12","17",29
"9226","Natallie","F","12","17",29
"9255","Rayelle","F","12","17",29
"9261","Rhett","F","12","17",29
"9280","Sam","F","12","17",29
"9286","Sarabi","F","12","17",29
"9318","Tisha","F","12","17",29
"9319","Tiwatope","F","12","17",29
"9333","Vung","F","12","17",29
"9336","Wylee","F","12","17",29
"9398","Alynah","F","11","18",29
"9420","Arrie","F","11","18",29
"9434","Averlee","F","11","18",29
"9453","Bralyn","F","11","18",29
"9459","Brihana","F","11","18",29
"9512","Dawt","F","11","18",29
"9559","Galaxy","F","11","18",29
"9709","Leiya","F","11","18",29
"9716","Lilie","F","11","18",29
"9741","Maily","F","11","18",29
"9753","Maryjo","F","11","18",29
"9805","Nohea","F","11","18",29
"9817","Osiris","F","11","18",29
"9831","Rabia","F","11","18",29
"9889","Sophee","F","11","18",29
"9926","Viera","F","11","18",29
"10006","Ameilia","F","10","19",29
"10016","Andra","F","10","19",29
"10052","Ayeza","F","10","19",29
"10055","Baker","F","10","19",29
"10253","Karyn","F","10","19",29
"10291","Koree","F","10","19",29
"10295","Kylyn","F","10","19",29
"10529","Tamyah","F","10","19",29
"10611","Adrionna","F","9","20",29
"11230","Remingtyn","F","9","20",29
"11906","Maddyx","F","8","21",29
"14347","Bellatrix","F","5","24",29
"14642","Jani","F","5","24",29
"15187","Westlyn","F","5","24",29
"6060","Dajah","F","21","7",28
"6296","Isyss","F","20","8",28
"6421","Abbagail","F","19","9",28
"6478","Cashmere","F","19","9",28
"6579","Lucila","F","19","9",28
"6605","Morgen","F","19","9",28
"6659","Shaylene","F","19","9",28
"6707","Ameriah","F","18","10",28
"6763","Delicia","F","18","10",28
"6764","Deniya","F","18","10",28
"6770","Diora","F","18","10",28
"6791","Genna","F","18","10",28
"6921","Teah","F","18","10",28
"6999","Camrie","F","17","11",28
"7013","Dalina","F","17","11",28
"7022","Devine","F","17","11",28
"7028","Electra","F","17","11",28
"7031","Emiline","F","17","11",28
"7058","Iyannah","F","17","11",28
"7094","Korynn","F","17","11",28
"7117","Maika","F","17","11",28
"7139","Mili","F","17","11",28
"7151","Nereida","F","17","11",28
"7155","Oksana","F","17","11",28
"7179","Saraiah","F","17","11",28
"7189","Shyloh","F","17","11",28
"7232","Abcde","F","16","12",28
"7244","Ailah","F","16","12",28
"7247","Akiyah","F","16","12",28
"7254","Alianys","F","16","12",28
"7257","Alyssah","F","16","12",28
"7263","Ameris","F","16","12",28
"7274","Aphrodite","F","16","12",28
"7347","Emmakate","F","16","12",28
"7353","Everli","F","16","12",28
"7376","Jaelani","F","16","12",28
"7391","Jordi","F","16","12",28
"7392","Jorgia","F","16","12",28
"7406","Kenzly","F","16","12",28
"7419","Lanai","F","16","12",28
"7422","Laysha","F","16","12",28
"7431","Lovella","F","16","12",28
"7452","Melaney","F","16","12",28
"7456","Michell","F","16","12",28
"7472","Noeli","F","16","12",28
"7477","Nyx","F","16","12",28
"7491","Rameen","F","16","12",28
"7496","Reilynn","F","16","12",28
"7511","Sativa","F","16","12",28
"7539","Tiyanna","F","16","12",28
"7569","Aara","F","15","13",28
"7590","Aivy","F","15","13",28
"7595","Alexsa","F","15","13",28
"7610","Anel","F","15","13",28
"7624","Ashna","F","15","13",28
"7634","Bani","F","15","13",28
"7638","Blessed","F","15","13",28
"7666","Christopher","F","15","13",28
"7693","Dhanya","F","15","13",28
"7703","Erinn","F","15","13",28
"7721","Hazley","F","15","13",28
"7736","Jaysa","F","15","13",28
"7745","Josiah","F","15","13",28
"7762","Kayliah","F","15","13",28
"7763","Kaytlyn","F","15","13",28
"7769","Kenady","F","15","13",28
"7784","Kinzee","F","15","13",28
"7786","Kynnadi","F","15","13",28
"7791","Leannah","F","15","13",28
"7792","Leeanne","F","15","13",28
"7808","Madlynn","F","15","13",28
"7836","Mileah","F","15","13",28
"7846","Nairi","F","15","13",28
"7864","Peightyn","F","15","13",28
"7872","Ramla","F","15","13",28
"7882","Rhylynn","F","15","13",28
"7894","Ryelynn","F","15","13",28
"7896","Saanvika","F","15","13",28
"7899","Savayah","F","15","13",28
"7915","Soliyana","F","15","13",28
"7934","Tenleigh","F","15","13",28
"7935","Tera","F","15","13",28
"7946","Whitleigh","F","15","13",28
"7971","Adelyna","F","14","14",28
"7975","Ahlaya","F","14","14",28
"8004","Anouk","F","14","14",28
"8008","Arfa","F","14","14",28
"8064","Dallie","F","14","14",28
"8076","Dezarae","F","14","14",28
"8125","Jalaiyah","F","14","14",28
"8128","Jameelah","F","14","14",28
"8172","Keeli","F","14","14",28
"8180","Keva","F","14","14",28
"8198","Kyndra","F","14","14",28
"8202","Lalah","F","14","14",28
"8273","Noraa","F","14","14",28
"8374","Xavia","F","14","14",28
"8397","Zyrah","F","14","14",28
"8409","Adryana","F","13","15",28
"8410","Adylene","F","13","15",28
"8422","Alivya","F","13","15",28
"8427","Allysson","F","13","15",28
"8431","Amar","F","13","15",28
"8447","Ariahna","F","13","15",28
"8451","Aryahi","F","13","15",28
"8453","Aryssa","F","13","15",28
"8458","Athea","F","13","15",28
"8514","Delanee","F","13","15",28
"8517","Dezi","F","13","15",28
"8522","Diva","F","13","15",28
"8542","Elysse","F","13","15",28
"8544","Emelynn","F","13","15",28
"8546","Emylia","F","13","15",28
"8577","Iviana","F","13","15",28
"8592","Janani","F","13","15",28
"8617","Katriel","F","13","15",28
"8619","Kayelynn","F","13","15",28
"8623","Keiko","F","13","15",28
"8637","Lailynn","F","13","15",28
"8639","Lanay","F","13","15",28
"8640","Lanora","F","13","15",28
"8645","Layloni","F","13","15",28
"8656","Lilyonna","F","13","15",28
"8657","Lisamarie","F","13","15",28
"8671","Mackensie","F","13","15",28
"8683","Margret","F","13","15",28
"8689","Masie","F","13","15",28
"8717","Namine","F","13","15",28
"8719","Narjis","F","13","15",28
"8754","Porsha","F","13","15",28
"8773","Ruhama","F","13","15",28
"8779","Saloma","F","13","15",28
"8782","Samhitha","F","13","15",28
"8824","Tzirel","F","13","15",28
"8826","Valen","F","13","15",28
"8827","Vianne","F","13","15",28
"8894","Amahia","F","12","16",28
"8897","Ameliyah","F","12","16",28
"8898","Amiliah","F","12","16",28
"8909","Annais","F","12","16",28
"8923","Ashia","F","12","16",28
"8939","Avrielle","F","12","16",28
"8959","Brentley","F","12","16",28
"8987","Daja","F","12","16",28
"9038","Faryn","F","12","16",28
"9039","Freda","F","12","16",28
"9066","Ireoluwa","F","12","16",28
"9083","Jasani","F","12","16",28
"9132","Kenlei","F","12","16",28
"9164","Liany","F","12","16",28
"9168","Linh","F","12","16",28
"9203","Matti","F","12","16",28
"9257","Rebekkah","F","12","16",28
"9273","Saara","F","12","16",28
"9346","Zamyra","F","12","16",28
"9369","Addisynn","F","11","17",28
"9401","Anaaya","F","11","17",28
"9424","Ashira","F","11","17",28
"9521","Devika","F","11","17",28
"9643","Kamren","F","11","17",28
"9652","Kataleah","F","11","17",28
"9664","Kenedy","F","11","17",28
"9672","Kiari","F","11","17",28
"9698","Laelia","F","11","17",28
"9752","Maryiah","F","11","17",28
"9789","Nefertiti","F","11","17",28
"9814","Onika","F","11","17",28
"9847","Roseanne","F","11","17",28
"9850","Ruweyda","F","11","17",28
"9851","Rynlee","F","11","17",28
"9880","Sidrah","F","11","17",28
"9920","Varvara","F","11","17",28
"9962","Aarianna","F","10","18",28
"10150","Finlay","F","10","18",28
"10347","Magda","F","10","18",28
"10426","Nyari","F","10","18",28
"10427","Nyema","F","10","18",28
"10464","Reigan","F","10","18",28
"10580","Zanovia","F","10","18",28
"10914","Hebe","F","9","19",28
"11225","Raphaela","F","9","19",28
"11778","Johari","F","8","20",28
"11821","Kayonna","F","8","20",28
"11951","Marylynn","F","8","20",28
"11987","Moriyah","F","8","20",28
"12493","Ellenore","F","7","21",28
"13210","Aima","F","6","22",28
"13591","Jazara","F","6","22",28
"14110","Westyn","F","6","22",28
"6194","Venessa","F","21","6",27
"6396","Sherlin","F","20","7",27
"6604","Minah","F","19","8",27
"6702","Alyn","F","18","9",27
"6729","Baby","F","18","9",27
"6733","Brayli","F","18","9",27
"6751","Crista","F","18","9",27
"6752","Cyncere","F","18","9",27
"6768","Devanie","F","18","9",27
"6802","Honest","F","18","9",27
"6808","Jaeliana","F","18","9",27
"6840","Lariya","F","18","9",27
"6848","Lidya","F","18","9",27
"6949","Adalaya","F","17","10",27
"6962","Allizon","F","17","10",27
"6975","Ashtin","F","17","10",27
"6985","Ayriana","F","17","10",27
"6994","Brody","F","17","10",27
"7021","Decklyn","F","17","10",27
"7070","Jennika","F","17","10",27
"7076","Kailan","F","17","10",27
"7080","Karmah","F","17","10",27
"7096","Kyrsten","F","17","10",27
"7109","Lydiann","F","17","10",27
"7140","Miyonna","F","17","10",27
"7142","Myana","F","17","10",27
"7166","Reagyn","F","17","10",27
"7172","Riham","F","17","10",27
"7220","Yachet","F","17","10",27
"7258","Amberleigh","F","16","11",27
"7275","Arabel","F","16","11",27
"7289","Avarae","F","16","11",27
"7296","Bayler","F","16","11",27
"7297","Beckham","F","16","11",27
"7312","Carolann","F","16","11",27
"7327","Daleisa","F","16","11",27
"7343","Elianys","F","16","11",27
"7371","Illyanna","F","16","11",27
"7399","Kariana","F","16","11",27
"7405","Kelaiah","F","16","11",27
"7407","Keyani","F","16","11",27
"7439","Mairany","F","16","11",27
"7442","Malaak","F","16","11",27
"7448","Maribeth","F","16","11",27
"7451","Mckenley","F","16","11",27
"7461","Mushka","F","16","11",27
"7483","Pennie","F","16","11",27
"7497","Rhilee","F","16","11",27
"7506","Samyia","F","16","11",27
"7532","Tarynn","F","16","11",27
"7545","Vani","F","16","11",27
"7557","Zairah","F","16","11",27
"7572","Abigal","F","15","12",27
"7582","Adeola","F","15","12",27
"7614","Annalisse","F","15","12",27
"7618","Aribelle","F","15","12",27
"7630","Azalynn","F","15","12",27
"7647","Breena","F","15","12",27
"7655","Caisley","F","15","12",27
"7659","Caralynn","F","15","12",27
"7663","Catie","F","15","12",27
"7677","Cortney","F","15","12",27
"7680","Daliana","F","15","12",27
"7688","Devani","F","15","12",27
"7709","Fariha","F","15","12",27
"7750","Kaisyn","F","15","12",27
"7813","Mailee","F","15","12",27
"7822","Maleiah","F","15","12",27
"7827","Matthew","F","15","12",27
"7835","Mikiyah","F","15","12",27
"7837","Milica","F","15","12",27
"7845","Nahlia","F","15","12",27
"7847","Naiyana","F","15","12",27
"7855","Novia","F","15","12",27
"7857","Nuvia","F","15","12",27
"7860","Omari","F","15","12",27
"7862","Paeton","F","15","12",27
"7900","Scottlynn","F","15","12",27
"7913","Skylinn","F","15","12",27
"7921","Starlet","F","15","12",27
"7929","Tamyra","F","15","12",27
"7932","Teghan","F","15","12",27
"7961","Zayli","F","15","12",27
"7972","Adryanna","F","14","13",27
"7973","Aemilia","F","14","13",27
"7985","Alika","F","14","13",27
"8001","Anise","F","14","13",27
"8024","Aytana","F","14","13",27
"8028","Bellany","F","14","13",27
"8062","Dalani","F","14","13",27
"8067","Danaya","F","14","13",27
"8069","Dash","F","14","13",27
"8072","Demari","F","14","13",27
"8074","Deriyah","F","14","13",27
"8078","Dhanvi","F","14","13",27
"8080","Dreama","F","14","13",27
"8109","Haizel","F","14","13",27
"8131","Janea","F","14","13",27
"8143","Jazmarie","F","14","13",27
"8168","Katerine","F","14","13",27
"8183","Khalilah","F","14","13",27
"8199","Kynlei","F","14","13",27
"8218","Lizet","F","14","13",27
"8227","Mahika","F","14","13",27
"8239","Maziyah","F","14","13",27
"8250","Myranda","F","14","13",27
"8253","Naavya","F","14","13",27
"8257","Nakshatra","F","14","13",27
"8272","Nolyn","F","14","13",27
"8288","Raniah","F","14","13",27
"8320","Siona","F","14","13",27
"8323","Smriti","F","14","13",27
"8324","Soniya","F","14","13",27
"8387","Zenna","F","14","13",27
"8401","Adaleen","F","13","14",27
"8412","Ahmia","F","13","14",27
"8428","Alonni","F","13","14",27
"8433","Amarri","F","13","14",27
"8436","Analina","F","13","14",27
"8445","Annaya","F","13","14",27
"8464","Averyana","F","13","14",27
"8507","Damaria","F","13","14",27
"8561","Graziella","F","13","14",27
"8563","Hajra","F","13","14",27
"8573","Ilia","F","13","14",27
"8574","Iliyah","F","13","14",27
"8584","Jaeleigh","F","13","14",27
"8633","Kylani","F","13","14",27
"8707","Millee","F","13","14",27
"8751","Phenix","F","13","14",27
"8758","Rainie","F","13","14",27
"8760","Reata","F","13","14",27
"8794","Shaylah","F","13","14",27
"8797","Shifa","F","13","14",27
"8820","Torrance","F","13","14",27
"8847","Zylee","F","13","14",27
"8850","Aamilah","F","12","15",27
"8858","Addalyne","F","12","15",27
"8875","Akina","F","12","15",27
"8957","Bora","F","12","15",27
"8973","Carah","F","12","15",27
"8980","Chayce","F","12","15",27
"8986","Dahiana","F","12","15",27
"8990","Daleah","F","12","15",27
"9002","Deklynn","F","12","15",27
"9007","Denae","F","12","15",27
"9016","Eleonor","F","12","15",27
"9023","Emillie","F","12","15",27
"9068","Islay","F","12","15",27
"9099","Jolin","F","12","15",27
"9239","Ottilie","F","12","15",27
"9251","Rainbow","F","12","15",27
"9256","Raynah","F","12","15",27
"9281","Samuel","F","12","15",27
"9283","Sanika","F","12","15",27
"9288","Sargun","F","12","15",27
"9324","Tulsi","F","12","15",27
"9339","Xochilt","F","12","15",27
"9348","Zariana","F","12","15",27
"9358","Aaleah","F","11","16",27
"9400","Amiria","F","11","16",27
"9431","Avaiah","F","11","16",27
"9448","Berit","F","11","16",27
"9516","Delaila","F","11","16",27
"9548","Estee","F","11","16",27
"9619","Jisselle","F","11","16",27
"9623","Jonathan","F","11","16",27
"9739","Mahima","F","11","16",27
"9745","Man","F","11","16",27
"9774","Mily","F","11","16",27
"9828","Prisca","F","11","16",27
"9833","Raia","F","11","16",27
"9839","Reia","F","11","16",27
"9842","Rianne","F","11","16",27
"9868","Sedra","F","11","16",27
"9892","Sukhmani","F","11","16",27
"9933","Xylah","F","11","16",27
"9945","Yeshia","F","11","16",27
"9996","Alera","F","10","17",27
"10147","Evanie","F","10","17",27
"10209","Jannelle","F","10","17",27
"10336","Lyda","F","10","17",27
"10373","Marycatherine","F","10","17",27
"10388","Midori","F","10","17",27
"10490","Samera","F","10","17",27
"10506","Siddhi","F","10","17",27
"10551","Vayla","F","10","17",27
"10560","Wyllow","F","10","17",27
"10586","Zhara","F","10","17",27
"10825","Dhruvi","F","9","18",27
"10843","Elenor","F","9","18",27
"10952","Jaianna","F","9","18",27
"11646","Emmalise","F","8","19",27
"11659","Evonne","F","8","19",27
"11715","Ilyssa","F","8","19",27
"11843","Kobie","F","8","19",27
"11925","Maleigh","F","8","19",27
"12017","Nettie","F","8","19",27
"12264","Adyline","F","7","20",27
"12734","Kobe","F","7","20",27
"12924","Nitara","F","7","20",27
"12933","Novalyn","F","7","20",27
"14365","Brett","F","5","22",27
"14662","Jeily","F","5","22",27
"6065","Daylynn","F","21","5",26
"6324","Kina","F","20","6",26
"6491","Demaria","F","19","7",26
"6550","Karys","F","19","7",26
"6599","Meiah","F","19","7",26
"6705","Amarrah","F","18","8",26
"6720","Ariyan","F","18","8",26
"6741","Carmel","F","18","8",26
"6831","Kirstyn","F","18","8",26
"6860","Mariaclara","F","18","8",26
"6910","Shailyn","F","18","8",26
"6934","Yanessa","F","18","8",26
"6953","Aeriana","F","17","9",26
"6963","Alura","F","17","9",26
"6970","Angelis","F","17","9",26
"6973","Araiyah","F","17","9",26
"6974","Arushi","F","17","9",26
"7008","Christi","F","17","9",26
"7036","Evelette","F","17","9",26
"7103","Liliah","F","17","9",26
"7111","Lynnae","F","17","9",26
"7138","Milayna","F","17","9",26
"7191","Sinclair","F","17","9",26
"7206","Taygen","F","17","9",26
"7226","Zarriah","F","17","9",26
"7249","Alannie","F","16","10",26
"7250","Alannis","F","16","10",26
"7265","Amrita","F","16","10",26
"7272","Annleigh","F","16","10",26
"7352","Estephania","F","16","10",26
"7361","Gibson","F","16","10",26
"7364","Haniyah","F","16","10",26
"7370","Ifrah","F","16","10",26
"7383","Jayleah","F","16","10",26
"7398","Kalenna","F","16","10",26
"7404","Keilana","F","16","10",26
"7409","Kimberlin","F","16","10",26
"7512","Satori","F","16","10",26
"7517","Shiann","F","16","10",26
"7518","Shraddha","F","16","10",26
"7553","Yisel","F","16","10",26
"7556","Zainah","F","16","10",26
"7584","Ahaana","F","15","11",26
"7588","Ailana","F","15","11",26
"7625","Audreyanna","F","15","11",26
"7642","Brandie","F","15","11",26
"7658","Camilia","F","15","11",26
"7672","Cloie","F","15","11",26
"7679","Dalena","F","15","11",26
"7681","Damyah","F","15","11",26
"7700","Emmamae","F","15","11",26
"7714","Girl","F","15","11",26
"7719","Havannah","F","15","11",26
"7746","Julee","F","15","11",26
"7757","Kamylah","F","15","11",26
"7765","Keela","F","15","11",26
"7773","Keyona","F","15","11",26
"7817","Makia","F","15","11",26
"7829","Mayzee","F","15","11",26
"7832","Metztli","F","15","11",26
"7833","Micaella","F","15","11",26
"7834","Mikhaela","F","15","11",26
"7853","Nijah","F","15","11",26
"7863","Paysley","F","15","11",26
"7868","Racquel","F","15","11",26
"7875","Rayen","F","15","11",26
"7889","Roselina","F","15","11",26
"7897","Saavi","F","15","11",26
"7904","Shailey","F","15","11",26
"7939","Tinzley","F","15","11",26
"7969","Adaleena","F","14","12",26
"7974","Afomia","F","14","12",26
"7978","Aislee","F","14","12",26
"7987","Alveena","F","14","12",26
"8047","Carsynn","F","14","12",26
"8068","Dannah","F","14","12",26
"8085","Elenna","F","14","12",26
"8096","Erian","F","14","12",26
"8114","Hermela","F","14","12",26
"8129","Jamelia","F","14","12",26
"8136","Janvi","F","14","12",26
"8160","Kaisa","F","14","12",26
"8166","Karrigan","F","14","12",26
"8167","Kasidy","F","14","12",26
"8179","Ketzaly","F","14","12",26
"8187","Kimia","F","14","12",26
"8206","Lashae","F","14","12",26
"8221","Lucilla","F","14","12",26
"8232","Mareli","F","14","12",26
"8233","Maricarmen","F","14","12",26
"8254","Naba","F","14","12",26
"8262","Nayelie","F","14","12",26
"8268","Nima","F","14","12",26
"8283","Phinley","F","14","12",26
"8284","Pietra","F","14","12",26
"8287","Rakiyah","F","14","12",26
"8314","Shams","F","14","12",26
"8315","Shariya","F","14","12",26
"8328","Stellah","F","14","12",26
"8334","Sydnei","F","14","12",26
"8339","Takara","F","14","12",26
"8343","Tasmia","F","14","12",26
"8361","Tynslee","F","14","12",26
"8366","Videl","F","14","12",26
"8406","Adlyn","F","13","13",26
"8407","Adri","F","13","13",26
"8408","Adrie","F","13","13",26
"8413","Ahmiya","F","13","13",26
"8425","Allayah","F","13","13",26
"8429","Altair","F","13","13",26
"8455","Ashlen","F","13","13",26
"8500","Chyla","F","13","13",26
"8526","Dutchess","F","13","13",26
"8528","Dynasti","F","13","13",26
"8548","Evangelene","F","13","13",26
"8613","Kailen","F","13","13",26
"8614","Kaleya","F","13","13",26
"8630","Khamiyah","F","13","13",26
"8638","Lalani","F","13","13",26
"8669","Lynix","F","13","13",26
"8687","Marwah","F","13","13",26
"8690","Maxima","F","13","13",26
"8693","Mazy","F","13","13",26
"8698","Melena","F","13","13",26
"8699","Meral","F","13","13",26
"8725","Neeva","F","13","13",26
"8727","Neriyah","F","13","13",26
"8740","Ondine","F","13","13",26
"8742","Pailynn","F","13","13",26
"8747","Pearla","F","13","13",26
"8770","Rosely","F","13","13",26
"8772","Ruchel","F","13","13",26
"8785","Scotti","F","13","13",26
"8789","Seriah","F","13","13",26
"8809","Takiya","F","13","13",26
"8811","Tanyla","F","13","13",26
"8828","Vidhi","F","13","13",26
"8838","Zakira","F","13","13",26
"8844","Zita","F","13","13",26
"8855","Adalynd","F","12","14",26
"8880","Aleece","F","12","14",26
"8911","Anniah","F","12","14",26
"8946","Bana","F","12","14",26
"8950","Baylynn","F","12","14",26
"8962","Brina","F","12","14",26
"8971","Cally","F","12","14",26
"8994","Darcey","F","12","14",26
"8999","Dayonna","F","12","14",26
"9015","Eleah","F","12","14",26
"9045","Ghalia","F","12","14",26
"9047","Giovana","F","12","14",26
"9052","Haislee","F","12","14",26
"9133","Kenlynn","F","12","14",26
"9138","Khristian","F","12","14",26
"9150","Kourtlynn","F","12","14",26
"9182","Madyn","F","12","14",26
"9187","Makai","F","12","14",26
"9198","Marilena","F","12","14",26
"9216","Merrill","F","12","14",26
"9237","Oluwadamilola","F","12","14",26
"9263","Rhylin","F","12","14",26
"9301","Skylarr","F","12","14",26
"9321","Tovah","F","12","14",26
"9437","Aviendha","F","11","15",26
"9445","Bailynn","F","11","15",26
"9447","Bellami","F","11","15",26
"9478","Catrina","F","11","15",26
"9505","Daphnee","F","11","15",26
"9511","Daveah","F","11","15",26
"9532","Ekam","F","11","15",26
"9636","Kaleiah","F","11","15",26
"9655","Kathryne","F","11","15",26
"9677","Kimmy","F","11","15",26
"9699","Lama","F","11","15",26
"9728","Lydian","F","11","15",26
"9740","Maija","F","11","15",26
"9801","Nissa","F","11","15",26
"9803","Noble","F","11","15",26
"9808","Nyelli","F","11","15",26
"9811","Olina","F","11","15",26
"9834","Rainee","F","11","15",26
"9878","Sherly","F","11","15",26
"9935","Yalena","F","11","15",26
"9973","Adelheid","F","10","16",26
"10013","Anaika","F","10","16",26
"10025","Annaelle","F","10","16",26
"10032","Arien","F","10","16",26
"10073","Cana","F","10","16",26
"10182","Honestee","F","10","16",26
"10274","Kenyah","F","10","16",26
"10297","Laelle","F","10","16",26
"10417","Nidia","F","10","16",26
"10424","Novi","F","10","16",26
"10465","Renezmae","F","10","16",26
"10549","Tyleigh","F","10","16",26
"10555","Vitalia","F","10","16",26
"10608","Adely","F","9","17",26
"10864","Emmersen","F","9","17",26
"10869","Espen","F","9","17",26
"10876","Evani","F","9","17",26
"10885","Freyah","F","9","17",26
"10915","Hedy","F","9","17",26
"10971","Jaycelyn","F","9","17",26
"10981","Jernee","F","9","17",26
"11105","Lorie","F","9","17",26
"11320","Tehillah","F","9","17",26
"11348","Viya","F","9","17",26
"11367","Zabrina","F","9","17",26
"11405","Adilynne","F","8","18",26
"11415","Ailed","F","8","18",26
"12254","Addaleigh","F","7","19",26
"12338","Arshia","F","7","19",26
"12603","Jamilet","F","7","19",26
"12635","Jersi","F","7","19",26
"12817","Mahlani","F","7","19",26
"13069","Sophea","F","7","19",26
"6208","Aasiya","F","20","5",25
"6441","Amariona","F","19","6",25
"6717","Anneka","F","18","7",25
"6832","Klea","F","18","7",25
"6877","Montzerrat","F","18","7",25
"6905","Sanam","F","18","7",25
"6956","Alanny","F","17","8",25
"6960","Aleyssa","F","17","8",25
"6986","Baily","F","17","8",25
"6997","Caira","F","17","8",25
"7001","Canyon","F","17","8",25
"7039","Felix","F","17","8",25
"7087","Kenidee","F","17","8",25
"7177","Ruwayda","F","17","8",25
"7246","Airlie","F","16","9",25
"7253","Aleecia","F","16","9",25
"7288","Autymn","F","16","9",25
"7292","Ayisha","F","16","9",25
"7302","Breelle","F","16","9",25
"7306","Briyah","F","16","9",25
"7354","Evlyn","F","16","9",25
"7358","Fathima","F","16","9",25
"7411","Klani","F","16","9",25
"7443","Malachi","F","16","9",25
"7453","Meliana","F","16","9",25
"7469","Neya","F","16","9",25
"7485","Raelene","F","16","9",25
"7490","Ralynn","F","16","9",25
"7507","Saralyn","F","16","9",25
"7509","Saryiah","F","16","9",25
"7510","Sascha","F","16","9",25
"7519","Shravya","F","16","9",25
"7534","Temiloluwa","F","16","9",25
"7546","Vidya","F","16","9",25
"7563","Zenya","F","16","9",25
"7567","Zuriyah","F","16","9",25
"7568","Aamirah","F","15","10",25
"7575","Abygale","F","15","10",25
"7578","Adayah","F","15","10",25
"7579","Addilynne","F","15","10",25
"7599","Allyse","F","15","10",25
"7643","Brayah","F","15","10",25
"7662","Cathalina","F","15","10",25
"7696","Elinore","F","15","10",25
"7699","Emaree","F","15","10",25
"7701","Emmory","F","15","10",25
"7725","Iana","F","15","10",25
"7743","Jordanna","F","15","10",25
"7753","Kalii","F","15","10",25
"7754","Kamarie","F","15","10",25
"7758","Karcyn","F","15","10",25
"7770","Kensly","F","15","10",25
"7805","Mabelle","F","15","10",25
"7830","Mazey","F","15","10",25
"7841","Mishelle","F","15","10",25
"7844","Myliah","F","15","10",25
"7850","Nandi","F","15","10",25
"7874","Raquelle","F","15","10",25
"7878","Rebekka","F","15","10",25
"7879","Reilyn","F","15","10",25
"7881","Renesmay","F","15","10",25
"7903","Shailee","F","15","10",25
"7910","Shristi","F","15","10",25
"7922","Starlett","F","15","10",25
"7923","Su","F","15","10",25
"7925","Sumayah","F","15","10",25
"7936","Teyla","F","15","10",25
"7940","Toryn","F","15","10",25
"7945","Viva","F","15","10",25
"7983","Aleta","F","14","11",25
"7998","Analya","F","14","11",25
"7999","Andilyn","F","14","11",25
"8005","Apple","F","14","11",25
"8011","Ashanty","F","14","11",25
"8020","Aviv","F","14","11",25
"8035","Blayklee","F","14","11",25
"8054","Chevi","F","14","11",25
"8055","Cheyanna","F","14","11",25
"8077","Deziree","F","14","11",25
"8088","Ellary","F","14","11",25
"8095","Eniya","F","14","11",25
"8097","Eriane","F","14","11",25
"8106","Haelyn","F","14","11",25
"8134","Janise","F","14","11",25
"8135","Jannely","F","14","11",25
"8140","Jaydyn","F","14","11",25
"8149","Jessamine","F","14","11",25
"8151","Joceline","F","14","11",25
"8156","Kade","F","14","11",25
"8189","Kodee","F","14","11",25
"8195","Krithika","F","14","11",25
"8203","Lamyia","F","14","11",25
"8215","Lilja","F","14","11",25
"8241","Meilanie","F","14","11",25
"8249","Mylene","F","14","11",25
"8261","Nasiah","F","14","11",25
"8300","Rosamaria","F","14","11",25
"8309","Saydi","F","14","11",25
"8317","Shukri","F","14","11",25
"8321","Sivan","F","14","11",25
"8327","Stacia","F","14","11",25
"8331","Sumeya","F","14","11",25
"8333","Suvi","F","14","11",25
"8356","Treazure","F","14","11",25
"8367","Vienne","F","14","11",25
"8377","Yamilett","F","14","11",25
"8380","Zamyah","F","14","11",25
"8400","Adabella","F","13","12",25
"8414","Aidah","F","13","12",25
"8426","Alleyah","F","13","12",25
"8434","Amaryah","F","13","12",25
"8460","Audria","F","13","12",25
"8465","Averyanna","F","13","12",25
"8475","Azaryah","F","13","12",25
"8477","Benelli","F","13","12",25
"8490","Caidyn","F","13","12",25
"8492","Caleigha","F","13","12",25
"8502","Collyn","F","13","12",25
"8512","Deklyn","F","13","12",25
"8521","Dillyn","F","13","12",25
"8529","Ebba","F","13","12",25
"8537","Elisabetta","F","13","12",25
"8539","Ellianah","F","13","12",25
"8551","Eylin","F","13","12",25
"8554","Fatiha","F","13","12",25
"8560","Gracelin","F","13","12",25
"8565","Haydin","F","13","12",25
"8570","Holden","F","13","12",25
"8590","Jalicia","F","13","12",25
"8607","Jocie","F","13","12",25
"8615","Kalkidan","F","13","12",25
"8620","Kayson","F","13","12",25
"8651","Lenny","F","13","12",25
"8652","Lera","F","13","12",25
"8653","Liahna","F","13","12",25
"8655","Lilymae","F","13","12",25
"8659","Lisset","F","13","12",25
"8663","Lorelle","F","13","12",25
"8679","Makynli","F","13","12",25
"8682","Manuella","F","13","12",25
"8686","Marti","F","13","12",25
"8726","Neilani","F","13","12",25
"8732","Nita","F","13","12",25
"8746","Paysen","F","13","12",25
"8767","Rilynne","F","13","12",25
"8783","Samiha","F","13","12",25
"8787","Seleste","F","13","12",25
"8802","Sophiarose","F","13","12",25
"8803","Sue","F","13","12",25
"8843","Zelma","F","13","12",25
"8851","Aanshi","F","12","13",25
"8927","Aubreyana","F","12","13",25
"8936","Avira","F","12","13",25
"8944","Bailie","F","12","13",25
"8951","Beauty","F","12","13",25
"8991","Danasia","F","12","13",25
"9000","Daytona","F","12","13",25
"9022","Emalia","F","12","13",25
"9028","Esraa","F","12","13",25
"9037","Fareedah","F","12","13",25
"9049","Glendy","F","12","13",25
"9065","Irais","F","12","13",25
"9087","Jaydence","F","12","13",25
"9101","Juelz","F","12","13",25
"9110","Kamile","F","12","13",25
"9151","Krissy","F","12","13",25
"9173","Lumi","F","12","13",25
"9194","Mar","F","12","13",25
"9197","Marielys","F","12","13",25
"9210","Meleana","F","12","13",25
"9243","Petrona","F","12","13",25
"9245","Pragya","F","12","13",25
"9246","Pricilla","F","12","13",25
"9249","Quinlynn","F","12","13",25
"9266","Robynn","F","12","13",25
"9278","Safira","F","12","13",25
"9294","Shadia","F","12","13",25
"9306","Stellarose","F","12","13",25
"9310","Takayla","F","12","13",25
"9330","Vianca","F","12","13",25
"9350","Zelina","F","12","13",25
"9354","Zorah","F","12","13",25
"9479","Cece","F","11","14",25
"9485","Charlestyn","F","11","14",25
"9493","Coriana","F","11","14",25
"9495","Cory","F","11","14",25
"9500","Dakayla","F","11","14",25
"9507","Darielys","F","11","14",25
"9524","Dominga","F","11","14",25
"9534","Eliannah","F","11","14",25
"9562","Genessa","F","11","14",25
"9585","Ilham","F","11","14",25
"9596","Jaanvi","F","11","14",25
"9603","Jamylah","F","11","14",25
"9628","Judi","F","11","14",25
"9634","Kairah","F","11","14",25
"9648","Karima","F","11","14",25
"9668","Kharis","F","11","14",25
"9705","Lauriel","F","11","14",25
"9717","Lillien","F","11","14",25
"9747","Maraki","F","11","14",25
"9751","Mariyam","F","11","14",25
"9798","Nikoletta","F","11","14",25
"9810","Olamide","F","11","14",25
"9893","Suki","F","11","14",25
"9894","Surina","F","11","14",25
"9960","Zhane","F","11","14",25
"9968","Adaira","F","10","15",25
"9986","Airyanna","F","10","15",25
"9991","Alayja","F","10","15",25
"10017","Andrew","F","10","15",25
"10039","Arpi","F","10","15",25
"10077","Cera","F","10","15",25
"10136","Emilea","F","10","15",25
"10171","Harmani","F","10","15",25
"10206","Jamani","F","10","15",25
"10220","Jerusalem","F","10","15",25
"10240","Kaelie","F","10","15",25
"10252","Karolyne","F","10","15",25
"10283","Kingston","F","10","15",25
"10322","Linette","F","10","15",25
"10443","Pola","F","10","15",25
"10466","Reniya","F","10","15",25
"10478","Ruari","F","10","15",25
"10484","Sabria","F","10","15",25
"10523","Tahiri","F","10","15",25
"10534","Tehani","F","10","15",25
"10573","Yulieth","F","10","15",25
"10593","Zyan","F","10","15",25
"10594","Zyiah","F","10","15",25
"10615","Agata","F","9","16",25
"10663","Ameri","F","9","16",25
"10703","Arrayah","F","9","16",25
"10777","Charles","F","9","16",25
"10778","Charlii","F","9","16",25
"10785","Cicely","F","9","16",25
"10802","Danelle","F","9","16",25
"10818","Demoni","F","9","16",25
"11045","Keylani","F","9","16",25
"11118","Maelin","F","9","16",25
"11136","Mame","F","9","16",25
"11158","Mellie","F","9","16",25
"11255","Sabiha","F","9","16",25
"11262","Saliha","F","9","16",25
"11330","Tomi","F","9","16",25
"11343","Venna","F","9","16",25
"11347","Vivica","F","9","16",25
"11355","Yaira","F","9","16",25
"11361","Yilia","F","9","16",25
"11616","Dovie","F","8","17",25
"11632","Ellanie","F","8","17",25
"11705","Hikari","F","8","17",25
"11910","Maevyn","F","8","17",25
"11932","Marcelle","F","8","17",25
"11969","Mercer","F","8","17",25
"12050","Radley","F","8","17",25
"12068","Reyah","F","8","17",25
"12073","Rickie","F","8","17",25
"12085","Rosselyn","F","8","17",25
"12099","Saleena","F","8","17",25
"12111","Seline","F","8","17",25
"12161","Takiyah","F","8","17",25
"12325","Anthonella","F","7","18",25
"12341","Asani","F","7","18",25
"12494","Ellina","F","7","18",25
"12738","Korryn","F","7","18",25
"12784","Lindyn","F","7","18",25
"13157","Zaiyah","F","7","18",25
"13588","Jasiri","F","6","19",25
"13960","Reeya","F","6","19",25
"14560","Greicy","F","5","20",25
"6790","Geisha","F","18","6",24
"6959","Alexzandra","F","17","7",24
"7059","Jahliyah","F","17","7",24
"7063","Japji","F","17","7",24
"7118","Makhia","F","17","7",24
"7190","Sierrah","F","17","7",24
"7217","Vrinda","F","17","7",24
"7221","Yazleen","F","17","7",24
"7238","Adanya","F","16","8",24
"7278","Arienne","F","16","8",24
"7304","Brinlynn","F","16","8",24
"7319","Cinthya","F","16","8",24
"7329","Davionna","F","16","8",24
"7330","Derricka","F","16","8",24
"7359","Faythe","F","16","8",24
"7401","Kaye","F","16","8",24
"7427","Linzy","F","16","8",24
"7433","Lucas","F","16","8",24
"7460","Mizuki","F","16","8",24
"7505","Saleah","F","16","8",24
"7524","Solace","F","16","8",24
"7528","Suraiya","F","16","8",24
"7543","Tyrianna","F","16","8",24
"7559","Zaliah","F","16","8",24
"7570","Aasha","F","15","9",24
"7577","Adasyn","F","15","9",24
"7593","Alenah","F","15","9",24
"7602","Amely","F","15","9",24
"7604","Amisha","F","15","9",24
"7608","Anani","F","15","9",24
"7626","Audrinna","F","15","9",24
"7661","Carmin","F","15","9",24
"7665","Chrisley","F","15","9",24
"7669","Ciela","F","15","9",24
"7689","Devlyn","F","15","9",24
"7691","Deyonna","F","15","9",24
"7692","Deziray","F","15","9",24
"7711","Folasade","F","15","9",24
"7717","Hadlea","F","15","9",24
"7731","Jadynn","F","15","9",24
"7741","Jisele","F","15","9",24
"7752","Kalen","F","15","9",24
"7767","Keleigh","F","15","9",24
"7771","Kentley","F","15","9",24
"7779","Kiaya","F","15","9",24
"7789","Laryssa","F","15","9",24
"7802","Lunna","F","15","9",24
"7831","Meghana","F","15","9",24
"7880","Remas","F","15","9",24
"7883","Ridhima","F","15","9",24
"7884","Rinley","F","15","9",24
"7924","Sulema","F","15","9",24
"7937","Teyonna","F","15","9",24
"7951","Yaneliz","F","15","9",24
"7955","Yesly","F","15","9",24
"8018","Avey","F","14","10",24
"8026","Azula","F","14","10",24
"8043","Camara","F","14","10",24
"8048","Catalena","F","14","10",24
"8070","Daylani","F","14","10",24
"8092","Emie","F","14","10",24
"8094","Emmalou","F","14","10",24
"8101","Gena","F","14","10",24
"8102","Ghazal","F","14","10",24
"8111","Hampton","F","14","10",24
"8117","Houston","F","14","10",24
"8118","Inioluwa","F","14","10",24
"8124","Jalaiya","F","14","10",24
"8126","Jaleena","F","14","10",24
"8150","Jissel","F","14","10",24
"8154","Jozelyn","F","14","10",24
"8155","Julieanne","F","14","10",24
"8165","Karman","F","14","10",24
"8200","Kynzi","F","14","10",24
"8210","Leoni","F","14","10",24
"8212","Letizia","F","14","10",24
"8214","Lida","F","14","10",24
"8247","Myelle","F","14","10",24
"8248","Mylei","F","14","10",24
"8267","Nicki","F","14","10",24
"8282","Peyson","F","14","10",24
"8298","Rosalba","F","14","10",24
"8302","Ryenn","F","14","10",24
"8322","Skylor","F","14","10",24
"8325","Sonoma","F","14","10",24
"8335","Symphoni","F","14","10",24
"8336","Tahirah","F","14","10",24
"8338","Tailor","F","14","10",24
"8346","Teona","F","14","10",24
"8357","Tris","F","14","10",24
"8359","Tuleen","F","14","10",24
"8368","Viona","F","14","10",24
"8371","Waverley","F","14","10",24
"8372","Wrenna","F","14","10",24
"8398","Abena","F","13","11",24
"8411","Afrah","F","13","11",24
"8441","Angelyna","F","13","11",24
"8459","Athziry","F","13","11",24
"8461","Aunesti","F","13","11",24
"8463","Avenly","F","13","11",24
"8480","Braylinn","F","13","11",24
"8497","Chaniya","F","13","11",24
"8503","Cricket","F","13","11",24
"8504","Cyanna","F","13","11",24
"8531","Edeline","F","13","11",24
"8532","Eilidh","F","13","11",24
"8543","Emary","F","13","11",24
"8564","Halona","F","13","11",24
"8569","Hibba","F","13","11",24
"8576","Ivania","F","13","11",24
"8578","Iviona","F","13","11",24
"8582","Jadie","F","13","11",24
"8598","Jeanie","F","13","11",24
"8599","Jenise","F","13","11",24
"8612","Kaaliyah","F","13","11",24
"8616","Kalyani","F","13","11",24
"8644","Layliana","F","13","11",24
"8661","Lizmarie","F","13","11",24
"8668","Lyniah","F","13","11",24
"8670","Lynnon","F","13","11",24
"8678","Makala","F","13","11",24
"8681","Maneh","F","13","11",24
"8691","Maylea","F","13","11",24
"8695","Meia","F","13","11",24
"8723","Naveya","F","13","11",24
"8737","Olanna","F","13","11",24
"8745","Pascale","F","13","11",24
"8749","Pema","F","13","11",24
"8752","Pheonix","F","13","11",24
"8755","Preslyn","F","13","11",24
"8764","Renea","F","13","11",24
"8791","Shaliyah","F","13","11",24
"8804","Sybella","F","13","11",24
"8806","Syrenity","F","13","11",24
"8810","Talisha","F","13","11",24
"8813","Tayanna","F","13","11",24
"8814","Taylour","F","13","11",24
"8833","Yaneisy","F","13","11",24
"8836","Yosselin","F","13","11",24
"8845","Ziyan","F","13","11",24
"8857","Adaora","F","12","12",24
"8867","Aftyn","F","12","12",24
"8869","Ahriyah","F","12","12",24
"8874","Ajanae","F","12","12",24
"8881","Aleesha","F","12","12",24
"8905","Anavi","F","12","12",24
"8912","Annlee","F","12","12",24
"8917","Apolonia","F","12","12",24
"8920","Arshi","F","12","12",24
"8922","Ashari","F","12","12",24
"8924","Aslynn","F","12","12",24
"8931","Aunisty","F","12","12",24
"8938","Avrey","F","12","12",24
"8942","Ayari","F","12","12",24
"8945","Bailyn","F","12","12",24
"8956","Blessings","F","12","12",24
"8976","Catalea","F","12","12",24
"8977","Catharine","F","12","12",24
"8982","Claudette","F","12","12",24
"8997","Dayleen","F","12","12",24
"9034","Faelynn","F","12","12",24
"9053","Haivyn","F","12","12",24
"9088","Jaylina","F","12","12",24
"9089","Jaymi","F","12","12",24
"9111","Kamillah","F","12","12",24
"9114","Kamyrah","F","12","12",24
"9119","Kassiani","F","12","12",24
"9142","Kierah","F","12","12",24
"9156","Lanayah","F","12","12",24
"9163","Lianny","F","12","12",24
"9170","Lonnie","F","12","12",24
"9176","Lyssa","F","12","12",24
"9179","Madasyn","F","12","12",24
"9190","Makyiah","F","12","12",24
"9207","Mckynlie","F","12","12",24
"9209","Mehr","F","12","12",24
"9227","Naysha","F","12","12",24
"9236","Nyima","F","12","12",24
"9258","Reeve","F","12","12",24
"9259","Reiley","F","12","12",24
"9260","Renleigh","F","12","12",24
"9264","Rithika","F","12","12",24
"9297","Shruthi","F","12","12",24
"9307","Sumayya","F","12","12",24
"9312","Teighlor","F","12","12",24
"9316","Tiegan","F","12","12",24
"9331","Vihana","F","12","12",24
"9344","Yvanna","F","12","12",24
"9368","Abiha","F","11","13",24
"9379","Akane","F","11","13",24
"9392","Allora","F","11","13",24
"9396","Alyla","F","11","13",24
"9397","Alylah","F","11","13",24
"9409","Aneli","F","11","13",24
"9462","Cadie","F","11","13",24
"9468","California","F","11","13",24
"9509","Daryn","F","11","13",24
"9513","Daysia","F","11","13",24
"9525","Donatella","F","11","13",24
"9543","Emilija","F","11","13",24
"9586","Illa","F","11","13",24
"9599","Jailani","F","11","13",24
"9612","Jenavie","F","11","13",24
"9656","Kathrynn","F","11","13",24
"9663","Kemper","F","11","13",24
"9669","Kharter","F","11","13",24
"9670","Khia","F","11","13",24
"9673","Kiernan","F","11","13",24
"9679","Kinzlie","F","11","13",24
"9685","Konstantina","F","11","13",24
"9692","Kylene","F","11","13",24
"9710","Leland","F","11","13",24
"9712","Leo","F","11","13",24
"9750","Marily","F","11","13",24
"9767","Melyna","F","11","13",24
"9768","Merna","F","11","13",24
"9790","Neko","F","11","13",24
"9793","Neviah","F","11","13",24
"9797","Niko","F","11","13",24
"9804","Noha","F","11","13",24
"9818","Oswin","F","11","13",24
"9905","Taylinn","F","11","13",24
"9913","Trystan","F","11","13",24
"9917","Valyn","F","11","13",24
"9921","Vi","F","11","13",24
"9924","Vicki","F","11","13",24
"9938","Yanni","F","11","13",24
"9943","Yeilyn","F","11","13",24
"9998","Alira","F","10","14",24
"10002","Allis","F","10","14",24
"10049","Averiana","F","10","14",24
"10090","Corin","F","10","14",24
"10113","Demia","F","10","14",24
"10122","Duchess","F","10","14",24
"10132","Elley","F","10","14",24
"10140","Enola","F","10","14",24
"10162","Grae","F","10","14",24
"10179","Herlinda","F","10","14",24
"10196","Jagger","F","10","14",24
"10208","Janayla","F","10","14",24
"10260","Kaylia","F","10","14",24
"10262","Kayslee","F","10","14",24
"10273","Kennley","F","10","14",24
"10293","Kwynn","F","10","14",24
"10320","Lilyanah","F","10","14",24
"10330","Lorianne","F","10","14",24
"10342","Maat","F","10","14",24
"10421","Nishika","F","10","14",24
"10477","Ruah","F","10","14",24
"10483","Ryn","F","10","14",24
"10508","Sonni","F","10","14",24
"10525","Talina","F","10","14",24
"10545","Trixie","F","10","14",24
"10602","Abeeha","F","9","15",24
"10624","Aidel","F","9","15",24
"10676","Angelisse","F","9","15",24
"10694","Ariann","F","9","15",24
"10712","Avanthika","F","9","15",24
"10798","Dalaysia","F","9","15",24
"10944","Itzae","F","9","15",24
"10957","Jalexa","F","9","15",24
"11000","Jossalyn","F","9","15",24
"11009","Kalaysia","F","9","15",24
"11022","Karrie","F","9","15",24
"11026","Katalea","F","9","15",24
"11029","Kawthar","F","9","15",24
"11069","Labella","F","9","15",24
"11081","Larae","F","9","15",24
"11112","Lynne","F","9","15",24
"11122","Maimuna","F","9","15",24
"11231","Renna","F","9","15",24
"11270","Sanyla","F","9","15",24
"11353","Xitlalli","F","9","15",24
"11443","Amrit","F","8","16",24
"11448","Analeya","F","8","16",24
"11489","Athira","F","8","16",24
"11761","Jenisis","F","8","16",24
"11819","Kaydyn","F","8","16",24
"12221","Zanayah","F","8","16",24
"12229","Ziyonna","F","8","16",24
"12415","Cannon","F","7","17",24
"12523","Faduma","F","7","17",24
"12680","Kasidee","F","7","17",24
"12695","Keiana","F","7","17",24
"12729","Kiyara","F","7","17",24
"12802","Lucine","F","7","17",24
"13073","Stephenie","F","7","17",24
"13133","Yailin","F","7","17",24
"13146","Yesli","F","7","17",24
"13220","Aleesia","F","6","18",24
"13898","Niyati","F","6","18",24
"14000","Saia","F","6","18",24
"14366","Brexlee","F","5","19",24
"6950","Adalyna","F","17","6",23
"6964","Alynn","F","17","6",23
"6989","Betzabeth","F","17","6",23
"7027","Eknoor","F","17","6",23
"7074","Kabella","F","17","6",23
"7164","Raelan","F","17","6",23
"7256","Alys","F","16","7",23
"7262","Amenah","F","16","7",23
"7285","Aubreana","F","16","7",23
"7384","Jehieli","F","16","7",23
"7420","Lanea","F","16","7",23
"7421","Lavayah","F","16","7",23
"7480","Paisly","F","16","7",23
"7550","Yakelin","F","16","7",23
"7615","Annel","F","15","8",23
"7645","Braylon","F","15","8",23
"7649","Briann","F","15","8",23
"7674","Coley","F","15","8",23
"7729","Izzah","F","15","8",23
"7738","Jazzalyn","F","15","8",23
"7740","Jeniya","F","15","8",23
"7775","Khalie","F","15","8",23
"7777","Khilee","F","15","8",23
"7796","Lilygrace","F","15","8",23
"7842","Mitzy","F","15","8",23
"7871","Rahima","F","15","8",23
"7898","Samyrah","F","15","8",23
"7905","Shailynn","F","15","8",23
"7906","Shaleah","F","15","8",23
"7908","Shasta","F","15","8",23
"7947","Wiley","F","15","8",23
"7950","Xolani","F","15","8",23
"7965","Aarilyn","F","14","9",23
"7977","Ahniyah","F","14","9",23
"7986","Alliah","F","14","9",23
"7995","Amparo","F","14","9",23
"8021","Avriana","F","14","9",23
"8033","Beya","F","14","9",23
"8063","Dalissa","F","14","9",23
"8079","Dominica","F","14","9",23
"8107","Haile","F","14","9",23
"8138","Jasnoor","F","14","9",23
"8152","Joniyah","F","14","9",23
"8169","Katina","F","14","9",23
"8186","Kileigh","F","14","9",23
"8220","Lorraina","F","14","9",23
"8246","My","F","14","9",23
"8266","Nejla","F","14","9",23
"8311","Serenitie","F","14","9",23
"8313","Shamaya","F","14","9",23
"8340","Talula","F","14","9",23
"8363","Vashti","F","14","9",23
"8378","Yaminah","F","14","9",23
"8392","Zohar","F","14","9",23
"8393","Zoii","F","14","9",23
"8423","Alixandria","F","13","10",23
"8432","Amarionna","F","13","10",23
"8440","Anelisse","F","13","10",23
"8444","Annasofia","F","13","10",23
"8470","Aylana","F","13","10",23
"8471","Aynslee","F","13","10",23
"8474","Azariya","F","13","10",23
"8484","Brenlynn","F","13","10",23
"8495","Caniya","F","13","10",23
"8516","Devanshi","F","13","10",23
"8519","Dharma","F","13","10",23
"8527","Dymond","F","13","10",23
"8555","Fenna","F","13","10",23
"8556","Fiza","F","13","10",23
"8580","Jadalee","F","13","10",23
"8593","Janilah","F","13","10",23
"8596","Jaymarie","F","13","10",23
"8605","Jesselle","F","13","10",23
"8611","Jynesis","F","13","10",23
"8621","Keelee","F","13","10",23
"8632","Kinslei","F","13","10",23
"8636","Laiana","F","13","10",23
"8641","Lanyiah","F","13","10",23
"8674","Madlyn","F","13","10",23
"8676","Maelys","F","13","10",23
"8685","Markie","F","13","10",23
"8688","Marylee","F","13","10",23
"8694","Mckensie","F","13","10",23
"8744","Paislei","F","13","10",23
"8757","Quincee","F","13","10",23
"8762","Reigna","F","13","10",23
"8768","Rishita","F","13","10",23
"8777","Sadaf","F","13","10",23
"8808","Taisha","F","13","10",23
"8815","Tayonna","F","13","10",23
"8822","Tricia","F","13","10",23
"8831","Xinyi","F","13","10",23
"8834","Yeimi","F","13","10",23
"8842","Zariel","F","13","10",23
"8862","Adriane","F","12","11",23
"8876","Alaena","F","12","11",23
"8882","Aleiza","F","12","11",23
"8914","Anthony","F","12","11",23
"8921","Aryiana","F","12","11",23
"8930","Audyn","F","12","11",23
"8941","Ayaka","F","12","11",23
"8970","Calaya","F","12","11",23
"8979","Chara","F","12","11",23
"8983","Clea","F","12","11",23
"8988","Daksha","F","12","11",23
"9020","Elliyah","F","12","11",23
"9033","Fadumo","F","12","11",23
"9042","Geanna","F","12","11",23
"9054","Halleigh","F","12","11",23
"9055","Halli","F","12","11",23
"9059","Hazen","F","12","11",23
"9067","Isaac","F","12","11",23
"9080","Jamilla","F","12","11",23
"9091","Jennalee","F","12","11",23
"9134","Kennah","F","12","11",23
"9141","Kianni","F","12","11",23
"9148","Koralee","F","12","11",23
"9167","Lillieann","F","12","11",23
"9174","Lynsey","F","12","11",23
"9188","Makalyn","F","12","11",23
"9204","Maxie","F","12","11",23
"9213","Merlin","F","12","11",23
"9230","Nimo","F","12","11",23
"9253","Raseel","F","12","11",23
"9275","Sabirin","F","12","11",23
"9284","Sanyah","F","12","11",23
"9293","Selenia","F","12","11",23
"9296","Shantelle","F","12","11",23
"9298","Sian","F","12","11",23
"9300","Sicilia","F","12","11",23
"9302","Skylen","F","12","11",23
"9311","Taline","F","12","11",23
"9337","Wynona","F","12","11",23
"9351","Zellie","F","12","11",23
"9390","Alissia","F","11","12",23
"9395","Alyia","F","11","12",23
"9404","Analayah","F","11","12",23
"9408","Andelyn","F","11","12",23
"9411","Angelene","F","11","12",23
"9418","Aradhana","F","11","12",23
"9425","Asli","F","11","12",23
"9494","Corianna","F","11","12",23
"9504","Danyella","F","11","12",23
"9544","Emiliya","F","11","12",23
"9556","Fleur","F","11","12",23
"9566","Graclynn","F","11","12",23
"9581","Hind","F","11","12",23
"9593","Ismahan","F","11","12",23
"9614","Jennavie","F","11","12",23
"9620","John","F","11","12",23
"9621","Jolisa","F","11","12",23
"9626","Joseph","F","11","12",23
"9627","Journe","F","11","12",23
"9640","Kalyna","F","11","12",23
"9646","Karai","F","11","12",23
"9678","Kimya","F","11","12",23
"9682","Kitzia","F","11","12",23
"9683","Kiyoko","F","11","12",23
"9722","Linkyn","F","11","12",23
"9729","Lylianna","F","11","12",23
"9731","Lynna","F","11","12",23
"9732","Madalyne","F","11","12",23
"9744","Malissa","F","11","12",23
"9755","Marysol","F","11","12",23
"9783","Nahara","F","11","12",23
"9788","Nea","F","11","12",23
"9795","Nicky","F","11","12",23
"9800","Nimco","F","11","12",23
"9841","Rhyder","F","11","12",23
"9853","Saddie","F","11","12",23
"9856","Sahira","F","11","12",23
"9871","Shalaya","F","11","12",23
"9875","Sharleen","F","11","12",23
"9876","Shealyn","F","11","12",23
"9884","Smith","F","11","12",23
"9888","Sonnie","F","11","12",23
"9897","Tahari","F","11","12",23
"9903","Tashi","F","11","12",23
"9906","Teairra","F","11","12",23
"9915","Umaiza","F","11","12",23
"9922","Via","F","11","12",23
"9931","Xandra","F","11","12",23
"9952","Zahrah","F","11","12",23
"9972","Adelae","F","10","13",23
"9977","Adiba","F","10","13",23
"9979","Adriella","F","10","13",23
"9985","Aily","F","10","13",23
"10015","Analiya","F","10","13",23
"10042","Ashvika","F","10","13",23
"10107","Dariella","F","10","13",23
"10117","Diala","F","10","13",23
"10119","Dmya","F","10","13",23
"10124","Eirene","F","10","13",23
"10135","Emiah","F","10","13",23
"10137","Emilyrose","F","10","13",23
"10167","Hadessah","F","10","13",23
"10210","Javaeh","F","10","13",23
"10228","Joory","F","10","13",23
"10230","Joycelynn","F","10","13",23
"10235","Julieana","F","10","13",23
"10237","Kadee","F","10","13",23
"10280","Khaylee","F","10","13",23
"10294","Kye","F","10","13",23
"10299","Lailyn","F","10","13",23
"10324","Liviya","F","10","13",23
"10333","Luisana","F","10","13",23
"10335","Lun","F","10","13",23
"10360","Maloni","F","10","13",23
"10374","Marykatherine","F","10","13",23
"10379","Mattingly","F","10","13",23
"10381","Maysie","F","10","13",23
"10385","Merelyn","F","10","13",23
"10391","Miko","F","10","13",23
"10392","Minsa","F","10","13",23
"10399","Nabeeha","F","10","13",23
"10412","Nazli","F","10","13",23
"10440","Persephanie","F","10","13",23
"10495","Secret","F","10","13",23
"10544","Trinidad","F","10","13",23
"10552","Venba","F","10","13",23
"10590","Ziyanna","F","10","13",23
"10595","Zykeria","F","10","13",23
"10618","Ahliyah","F","9","14",23
"10630","Airyana","F","9","14",23
"10639","Alianny","F","9","14",23
"10643","Aliviyah","F","9","14",23
"10645","Aliyanah","F","9","14",23
"10664","Amiaya","F","9","14",23
"10669","Amonie","F","9","14",23
"10675","Anella","F","9","14",23
"10702","Arnika","F","9","14",23
"10716","Aviyana","F","9","14",23
"10731","Bette","F","9","14",23
"10826","Dhwani","F","9","14",23
"10830","Dim","F","9","14",23
"10840","Elaya","F","9","14",23
"10881","Farhiya","F","9","14",23
"10886","Gabbriella","F","9","14",23
"10909","Hayla","F","9","14",23
"10924","Hooria","F","9","14",23
"10991","Jimma","F","9","14",23
"11075","Lakeyn","F","9","14",23
"11091","Leta","F","9","14",23
"11108","Lowen","F","9","14",23
"11144","Mariposa","F","9","14",23
"11147","Marvella","F","9","14",23
"11167","Mililani","F","9","14",23
"11193","Nickole","F","9","14",23
"11196","Nohemy","F","9","14",23
"11202","Nusrat","F","9","14",23
"11206","Oluwasemilore","F","9","14",23
"11229","Raziyah","F","9","14",23
"11244","Riyanshi","F","9","14",23
"11251","Royelle","F","9","14",23
"11268","Sani","F","9","14",23
"11287","Sokhna","F","9","14",23
"11292","Sorayah","F","9","14",23
"11307","Suzana","F","9","14",23
"11319","Teddy","F","9","14",23
"11321","Teia","F","9","14",23
"11346","Viktoriya","F","9","14",23
"11356","Yani","F","9","14",23
"11358","Yemariam","F","9","14",23
"11370","Zala","F","9","14",23
"11373","Zarria","F","9","14",23
"11380","Zoiey","F","9","14",23
"11614","Diyora","F","8","15",23
"11783","Jovee","F","8","15",23
"11820","Kaylynne","F","8","15",23
"11835","Kharisma","F","8","15",23
"11874","Lenni","F","8","15",23
"11879","Levy","F","8","15",23
"11933","Mariaeduarda","F","8","15",23
"11980","Mirakle","F","8","15",23
"12018","Niala","F","8","15",23
"12136","Sirenity","F","8","15",23
"12159","Synthia","F","8","15",23
"12187","Uriyah","F","8","15",23
"12190","Vanshika","F","8","15",23
"12332","Arelis","F","7","16",23
"12412","Cairo","F","7","16",23
"12476","Edelynn","F","7","16",23
"12497","Elvie","F","7","16",23
"12543","Giavanni","F","7","16",23
"12604","Jamisen","F","7","16",23
"12720","Khyra","F","7","16",23
"12857","Menna","F","7","16",23
"12954","Padme","F","7","16",23
"13127","Wrenly","F","7","16",23
"13481","Emerly","F","6","17",23
"13534","Halston","F","6","17",23
"13731","Laelyn","F","6","17",23
"13824","Meiyah","F","6","17",23
"14920","Mosley","F","5","18",23
"15058","Rumaisa","F","5","18",23
"7184","Shamia","F","17","5",22
"7236","Aby","F","16","6",22
"7261","Ameah","F","16","6",22
"7379","Jalee","F","16","6",22
"7390","Jona","F","16","6",22
"7425","Lilleigh","F","16","6",22
"7473","Nuriyah","F","16","6",22
"7475","Nyjah","F","16","6",22
"7520","Siah","F","16","6",22
"7611","Angeliyah","F","15","7",22
"7633","Babygirl","F","15","7",22
"7676","Coretta","F","15","7",22
"7686","Deaira","F","15","7",22
"7710","Feather","F","15","7",22
"7712","Gabbanelli","F","15","7",22
"7733","Jasmeen","F","15","7",22
"7748","Juri","F","15","7",22
"7764","Kc","F","15","7",22
"7785","Kinzy","F","15","7",22
"7788","Lanyah","F","15","7",22
"7820","Makynzee","F","15","7",22
"7866","Pricila","F","15","7",22
"7909","Shaylen","F","15","7",22
"7911","Shterna","F","15","7",22
"7956","Yoanna","F","15","7",22
"7991","Amazing","F","14","8",22
"8000","Andreana","F","14","8",22
"8010","Arriyah","F","14","8",22
"8016","Avamae","F","14","8",22
"8019","Avis","F","14","8",22
"8022","Ayame","F","14","8",22
"8039","Bridgit","F","14","8",22
"8053","Chessa","F","14","8",22
"8057","Ciin","F","14","8",22
"8142","Jazalyn","F","14","8",22
"8145","Jenesys","F","14","8",22
"8182","Keyasia","F","14","8",22
"8184","Kiandra","F","14","8",22
"8185","Kiely","F","14","8",22
"8207","Latavia","F","14","8",22
"8222","Lucrezia","F","14","8",22
"8223","Lumina","F","14","8",22
"8240","Mehreen","F","14","8",22
"8243","Merrin","F","14","8",22
"8258","Naliya","F","14","8",22
"8263","Nayeliz","F","14","8",22
"8271","Nohely","F","14","8",22
"8280","Perpetua","F","14","8",22
"8285","Raeanne","F","14","8",22
"8286","Rainah","F","14","8",22
"8305","Salima","F","14","8",22
"8319","Simar","F","14","8",22
"8329","Suhaila","F","14","8",22
"8347","Teri","F","14","8",22
"8369","Wallis","F","14","8",22
"8424","Allaina","F","13","9",22
"8435","Americus","F","13","9",22
"8439","Andreia","F","13","9",22
"8450","Ariyel","F","13","9",22
"8472","Ayushi","F","13","9",22
"8485","Bri","F","13","9",22
"8499","Christella","F","13","9",22
"8523","Dmiyah","F","13","9",22
"8557","Gardenia","F","13","9",22
"8568","Heran","F","13","9",22
"8571","Ian","F","13","9",22
"8591","Jamesha","F","13","9",22
"8610","Joyelle","F","13","9",22
"8618","Kaydi","F","13","9",22
"8627","Kenzlei","F","13","9",22
"8646","Leahna","F","13","9",22
"8664","Loriann","F","13","9",22
"8684","Mariem","F","13","9",22
"8700","Miagrace","F","13","9",22
"8701","Miakoda","F","13","9",22
"8728","Nevah","F","13","9",22
"8730","Nida","F","13","9",22
"8734","Nusaiba","F","13","9",22
"8753","Pixie","F","13","9",22
"8778","Sadey","F","13","9",22
"8786","Seema","F","13","9",22
"8788","Semiyah","F","13","9",22
"8807","Syria","F","13","9",22
"8812","Tatym","F","13","9",22
"8846","Zoraida","F","13","9",22
"8860","Adilenne","F","12","10",22
"8863","Adrien","F","12","10",22
"8871","Ailis","F","12","10",22
"8900","Amyri","F","12","10",22
"8902","Analena","F","12","10",22
"8932","Auriah","F","12","10",22
"8940","Axel","F","12","10",22
"8985","Cybil","F","12","10",22
"8995","Darianny","F","12","10",22
"9011","Dinora","F","12","10",22
"9012","Dori","F","12","10",22
"9018","Elianis","F","12","10",22
"9024","Emilya","F","12","10",22
"9032","Eveleen","F","12","10",22
"9048","Giovanni","F","12","10",22
"9061","Hila","F","12","10",22
"9074","Jakya","F","12","10",22
"9085","Jasiya","F","12","10",22
"9092","Jennalyn","F","12","10",22
"9105","Kaiulani","F","12","10",22
"9122","Kaymarie","F","12","10",22
"9123","Keatyn","F","12","10",22
"9136","Keylie","F","12","10",22
"9139","Khyleigh","F","12","10",22
"9144","Kilani","F","12","10",22
"9166","Lilinoe","F","12","10",22
"9172","Loreli","F","12","10",22
"9175","Lynzie","F","12","10",22
"9177","Maaliyah","F","12","10",22
"9200","Markella","F","12","10",22
"9205","Mayerly","F","12","10",22
"9212","Merit","F","12","10",22
"9215","Meron","F","12","10",22
"9222","Nadalyn","F","12","10",22
"9224","Nailani","F","12","10",22
"9262","Rhylen","F","12","10",22
"9267","Rosalena","F","12","10",22
"9279","Sakinah","F","12","10",22
"9290","Scarlettrose","F","12","10",22
"9308","Taaliyah","F","12","10",22
"9327","Urvi","F","12","10",22
"9329","Verenice","F","12","10",22
"9332","Viyona","F","12","10",22
"9343","Yuliza","F","12","10",22
"9353","Zimal","F","12","10",22
"9355","Zylie","F","12","10",22
"9360","Aariel","F","11","11",22
"9370","Addylynn","F","11","11",22
"9372","Adena","F","11","11",22
"9373","Adhvika","F","11","11",22
"9376","Ahnna","F","11","11",22
"9388","Alexcia","F","11","11",22
"9428","Aubreyella","F","11","11",22
"9429","Aunika","F","11","11",22
"9430","Autumnrose","F","11","11",22
"9435","Averleigh","F","11","11",22
"9436","Averley","F","11","11",22
"9440","Azaiah","F","11","11",22
"9457","Breeana","F","11","11",22
"9471","Caoimhe","F","11","11",22
"9476","Carmelita","F","11","11",22
"9487","Chidinma","F","11","11",22
"9491","Clementina","F","11","11",22
"9501","Danai","F","11","11",22
"9514","Daziyah","F","11","11",22
"9515","Deem","F","11","11",22
"9520","Destine","F","11","11",22
"9533","Elaria","F","11","11",22
"9539","Elya","F","11","11",22
"9547","Eriyanna","F","11","11",22
"9571","Hamda","F","11","11",22
"9583","Huntleigh","F","11","11",22
"9584","Iley","F","11","11",22
"9587","Imoni","F","11","11",22
"9595","Izzabell","F","11","11",22
"9608","Jaylei","F","11","11",22
"9610","Jaylynne","F","11","11",22
"9615","Jenova","F","11","11",22
"9625","Jose","F","11","11",22
"9633","Kailia","F","11","11",22
"9641","Kamariah","F","11","11",22
"9653","Katalena","F","11","11",22
"9658","Kayleeann","F","11","11",22
"9696","Ladonna","F","11","11",22
"9702","Latasha","F","11","11",22
"9713","Lexii","F","11","11",22
"9720","Lilyahna","F","11","11",22
"9721","Lilybelle","F","11","11",22
"9730","Lyndsay","F","11","11",22
"9737","Maezie","F","11","11",22
"9743","Maleeha","F","11","11",22
"9770","Mickey","F","11","11",22
"9772","Miles","F","11","11",22
"9786","Natalyah","F","11","11",22
"9815","Onora","F","11","11",22
"9836","Rand","F","11","11",22
"9844","Rileyann","F","11","11",22
"9855","Sahily","F","11","11",22
"9877","Shelia","F","11","11",22
"9886","Sohana","F","11","11",22
"9896","Syrai","F","11","11",22
"9902","Tarryn","F","11","11",22
"9908","Temple","F","11","11",22
"9919","Vannessa","F","11","11",22
"9923","Vianny","F","11","11",22
"9939","Yarah","F","11","11",22
"9957","Zakaria","F","11","11",22
"9974","Adelind","F","10","12",22
"9992","Albina","F","10","12",22
"10014","Analisse","F","10","12",22
"10022","Angy","F","10","12",22
"10023","Anisah","F","10","12",22
"10026","Annahi","F","10","12",22
"10036","Arlin","F","10","12",22
"10064","Blu","F","10","12",22
"10066","Breklyn","F","10","12",22
"10069","Cadynce","F","10","12",22
"10092","Cyniah","F","10","12",22
"10109","Davy","F","10","12",22
"10142","Eralynn","F","10","12",22
"10163","Graham","F","10","12",22
"10165","Gwendelyn","F","10","12",22
"10176","Henry","F","10","12",22
"10226","Johanny","F","10","12",22
"10239","Kaelah","F","10","12",22
"10257","Kayal","F","10","12",22
"10275","Kenyatta","F","10","12",22
"10312","Lenah","F","10","12",22
"10316","Lilianah","F","10","12",22
"10326","Liyla","F","10","12",22
"10328","Liyu","F","10","12",22
"10338","Lynnley","F","10","12",22
"10356","Malaysha","F","10","12",22
"10423","Noami","F","10","12",22
"10431","Olivya","F","10","12",22
"10446","Providence","F","10","12",22
"10450","Raha","F","10","12",22
"10461","Raynie","F","10","12",22
"10514","Sui","F","10","12",22
"10568","Yazlynn","F","10","12",22
"10574","Yvaine","F","10","12",22
"10606","Addalie","F","9","13",22
"10607","Adell","F","9","13",22
"10631","Akeira","F","9","13",22
"10672","Anamta","F","9","13",22
"10673","Anavey","F","9","13",22
"10696","Ariellah","F","9","13",22
"10793","Cydnee","F","9","13",22
"10795","Dacey","F","9","13",22
"10797","Dalayla","F","9","13",22
"10816","Demetra","F","9","13",22
"10819","Denasia","F","9","13",22
"10832","Dion","F","9","13",22
"10836","Dylynn","F","9","13",22
"10845","Elis","F","9","13",22
"10851","Elliet","F","9","13",22
"10891","Gorgeous","F","9","13",22
"10903","Harshini","F","9","13",22
"10905","Hartlynn","F","9","13",22
"10933","Iridessa","F","9","13",22
"10963","Janielys","F","9","13",22
"10982","Jerri","F","9","13",22
"11140","Marayah","F","9","13",22
"11198","Noralee","F","9","13",22
"11217","Raahi","F","9","13",22
"11243","Riven","F","9","13",22
"11247","Romey","F","9","13",22
"11249","Rosi","F","9","13",22
"11254","Sabah","F","9","13",22
"11265","Samayra","F","9","13",22
"11279","Shulamis","F","9","13",22
"11288","Sole","F","9","13",22
"11327","Tiarra","F","9","13",22
"11333","Trynity","F","9","13",22
"11339","Vaanya","F","9","13",22
"11345","Vika","F","9","13",22
"11350","Willo","F","9","13",22
"11352","Wylder","F","9","13",22
"11384","Aadhira","F","8","14",22
"11387","Aanaya","F","8","14",22
"11469","Areeba","F","8","14",22
"11482","Asees","F","8","14",22
"11500","Averianna","F","8","14",22
"11577","Coryn","F","8","14",22
"11586","Dallys","F","8","14",22
"11597","Davey","F","8","14",22
"11600","Delaynee","F","8","14",22
"11650","Erandy","F","8","14",22
"11675","Gem","F","8","14",22
"11700","Haylin","F","8","14",22
"11732","Jaiyah","F","8","14",22
"11780","Jolette","F","8","14",22
"11786","Jurnie","F","8","14",22
"11789","Kahliyah","F","8","14",22
"11791","Kailany","F","8","14",22
"11796","Kalana","F","8","14",22
"11838","Kinda","F","8","14",22
"11852","Kyilee","F","8","14",22
"12025","Niveah","F","8","14",22
"12027","Nohealani","F","8","14",22
"12028","Novalei","F","8","14",22
"12036","Ori","F","8","14",22
"12094","Ryliee","F","8","14",22
"12203","Yamilette","F","8","14",22
"12206","Yaslyn","F","8","14",22
"12319","Angelyne","F","7","15",22
"12358","Aviyanna","F","7","15",22
"12372","Azyiah","F","7","15",22
"12424","Cecillia","F","7","15",22
"12487","Elexia","F","7","15",22
"12537","Garnet","F","7","15",22
"12571","Ilya","F","7","15",22
"12633","Jermiyah","F","7","15",22
"12681","Kassi","F","7","15",22
"12693","Kaysi","F","7","15",22
"12726","Kingslee","F","7","15",22
"12760","Laureen","F","7","15",22
"12783","Lindi","F","7","15",22
"13059","Sira","F","7","15",22
"13108","Triana","F","7","15",22
"13113","Valley","F","7","15",22
"13123","Waylynn","F","7","15",22
"13143","Yeily","F","7","15",22
"13244","Alyanah","F","6","16",22
"13315","Athaliah","F","6","16",22
"13630","Kairee","F","6","16",22
"13932","Prairie","F","6","16",22
"13974","Romelia","F","6","16",22
"13988","Rushika","F","6","16",22
"14308","Astella","F","5","17",22
"14561","Greisy","F","5","17",22
"14830","Lunabelle","F","5","17",22
"7313","Caylah","F","16","5",21
"7441","Makenzye","F","16","5",21
"7446","Malillany","F","16","5",21
"7544","Uliana","F","16","5",21
"7564","Zerina","F","16","5",21
"7586","Ahrianna","F","15","6",21
"7609","Aneira","F","15","6",21
"7636","Beyla","F","15","6",21
"7668","Ciarra","F","15","6",21
"7737","Jazilyn","F","15","6",21
"7755","Kambryn","F","15","6",21
"7798","Londan","F","15","6",21
"7807","Mackinzie","F","15","6",21
"7818","Makynleigh","F","15","6",21
"7930","Taralynn","F","15","6",21
"7953","Yaritzel","F","15","6",21
"7976","Ahlayah","F","14","7",21
"8025","Azaya","F","14","7",21
"8040","Briyanna","F","14","7",21
"8041","Calani","F","14","7",21
"8065","Danaly","F","14","7",21
"8090","Elonna","F","14","7",21
"8091","Emalina","F","14","7",21
"8130","Janalee","F","14","7",21
"8147","Jeshia","F","14","7",21
"8157","Kaelan","F","14","7",21
"8161","Kamauri","F","14","7",21
"8193","Kortlyn","F","14","7",21
"8197","Kyliyah","F","14","7",21
"8209","Leire","F","14","7",21
"8211","Leslee","F","14","7",21
"8219","Lorianna","F","14","7",21
"8230","Makinzi","F","14","7",21
"8255","Naelle","F","14","7",21
"8326","Soraiya","F","14","7",21
"8330","Sujey","F","14","7",21
"8365","Vedanshi","F","14","7",21
"8416","Aiyah","F","13","8",21
"8437","Analissa","F","13","8",21
"8443","Annaliz","F","13","8",21
"8456","Ashlinn","F","13","8",21
"8483","Brekyn","F","13","8",21
"8493","Caliann","F","13","8",21
"8496","Caniyah","F","13","8",21
"8498","Charline","F","13","8",21
"8511","Dayanne","F","13","8",21
"8525","Drue","F","13","8",21
"8550","Evonna","F","13","8",21
"8558","Giavonni","F","13","8",21
"8567","Heela","F","13","8",21
"8583","Jaeleen","F","13","8",21
"8606","Jeweliana","F","13","8",21
"8642","Lanyla","F","13","8",21
"8665","Luzma","F","13","8",21
"8692","Mayukha","F","13","8",21
"8705","Milia","F","13","8",21
"8712","Mylena","F","13","8",21
"8722","Natia","F","13","8",21
"8776","Sabriel","F","13","8",21
"8780","Samaa","F","13","8",21
"8784","Sanayah","F","13","8",21
"8799","Simrat","F","13","8",21
"8800","Skarleth","F","13","8",21
"8805","Syren","F","13","8",21
"8817","Tien","F","13","8",21
"8835","Yitta","F","13","8",21
"8839","Zakyra","F","13","8",21
"8852","Absalat","F","12","9",21
"8859","Addysin","F","12","9",21
"8861","Adreana","F","12","9",21
"8890","Aliviana","F","12","9",21
"8891","Aliviya","F","12","9",21
"8903","Analisia","F","12","9",21
"8904","Analyssa","F","12","9",21
"8910","Annalisia","F","12","9",21
"8919","Arrietty","F","12","9",21
"8926","Aubrea","F","12","9",21
"8937","Avisha","F","12","9",21
"8967","Bryah","F","12","9",21
"9001","Deepika","F","12","9",21
"9005","Delmy","F","12","9",21
"9010","Destyn","F","12","9",21
"9026","Enslie","F","12","9",21
"9036","Fardowsa","F","12","9",21
"9056","Hamna","F","12","9",21
"9058","Haylynn","F","12","9",21
"9069","Itza","F","12","9",21
"9071","Ivannah","F","12","9",21
"9076","Jaleya","F","12","9",21
"9078","Jamee","F","12","9",21
"9096","Jina","F","12","9",21
"9116","Karmela","F","12","9",21
"9126","Kelcee","F","12","9",21
"9127","Kelcey","F","12","9",21
"9128","Kellan","F","12","9",21
"9137","Khalila","F","12","9",21
"9140","Khyli","F","12","9",21
"9159","Leniyah","F","12","9",21
"9191","Maleni","F","12","9",21
"9193","Manvi","F","12","9",21
"9195","Marabelle","F","12","9",21
"9218","Mikaylee","F","12","9",21
"9225","Nasreen","F","12","9",21
"9231","Nishi","F","12","9",21
"9232","Nishtha","F","12","9",21
"9242","Parys","F","12","9",21
"9248","Quetzali","F","12","9",21
"9250","Rahel","F","12","9",21
"9254","Rashelle","F","12","9",21
"9277","Saesha","F","12","9",21
"9304","Sonnet","F","12","9",21
"9328","Vedha","F","12","9",21
"9340","Yanelli","F","12","9",21
"9357","Aalaiyah","F","11","10",21
"9365","Aava","F","11","10",21
"9374","Adylee","F","11","10",21
"9387","Alene","F","11","10",21
"9433","Aveleen","F","11","10",21
"9442","Azaylea","F","11","10",21
"9454","Brandee","F","11","10",21
"9473","Cariana","F","11","10",21
"9489","Chynna","F","11","10",21
"9492","Copelyn","F","11","10",21
"9503","Dannika","F","11","10",21
"9519","Destanie","F","11","10",21
"9536","Elizabet","F","11","10",21
"9540","Emaya","F","11","10",21
"9552","Evolett","F","11","10",21
"9555","Finnlee","F","11","10",21
"9561","Genesee","F","11","10",21
"9570","Hajer","F","11","10",21
"9573","Haruka","F","11","10",21
"9577","Heloise","F","11","10",21
"9582","Hoda","F","11","10",21
"9589","Iola","F","11","10",21
"9597","Jahaira","F","11","10",21
"9598","Jahnae","F","11","10",21
"9622","Jolissa","F","11","10",21
"9642","Kambrey","F","11","10",21
"9661","Keaira","F","11","10",21
"9681","Kirin","F","11","10",21
"9690","Kyleen","F","11","10",21
"9691","Kyleigha","F","11","10",21
"9693","Kymberly","F","11","10",21
"9701","Laryah","F","11","10",21
"9719","Lillyrose","F","11","10",21
"9734","Madilyne","F","11","10",21
"9742","Malan","F","11","10",21
"9749","Marianny","F","11","10",21
"9756","Maryssa","F","11","10",21
"9776","Mishal","F","11","10",21
"9794","Niaomi","F","11","10",21
"9825","Posy","F","11","10",21
"9829","Priyana","F","11","10",21
"9858","Samanvitha","F","11","10",21
"9862","Santa","F","11","10",21
"9882","Skylynne","F","11","10",21
"9885","Sofya","F","11","10",21
"9900","Tallie","F","11","10",21
"9901","Talon","F","11","10",21
"9928","Weslee","F","11","10",21
"9932","Xayla","F","11","10",21
"9941","Yariana","F","11","10",21
"9942","Yasemin","F","11","10",21
"9953","Zaiah","F","11","10",21
"9955","Zaineb","F","11","10",21
"9956","Zakari","F","11","10",21
"9961","Zoria","F","11","10",21
"9964","Aaylah","F","10","11",21
"10009","Amily","F","10","11",21
"10047","Avaiyah","F","10","11",21
"10059","Bellagrace","F","10","11",21
"10062","Bijou","F","10","11",21
"10070","Caiah","F","10","11",21
"10074","Carole","F","10","11",21
"10088","Copper","F","10","11",21
"10094","Daeja","F","10","11",21
"10097","Dalal","F","10","11",21
"10101","Dallana","F","10","11",21
"10103","Danella","F","10","11",21
"10105","Danisha","F","10","11",21
"10123","Edison","F","10","11",21
"10125","Eislee","F","10","11",21
"10127","Elim","F","10","11",21
"10143","Erandi","F","10","11",21
"10153","Foster","F","10","11",21
"10158","Glorianna","F","10","11",21
"10166","Gwyn","F","10","11",21
"10188","Ileen","F","10","11",21
"10189","Ilithyia","F","10","11",21
"10190","Iliza","F","10","11",21
"10195","Jadaya","F","10","11",21
"10200","Jaileigh","F","10","11",21
"10205","Jalen","F","10","11",21
"10216","Jaylia","F","10","11",21
"10219","Jelissa","F","10","11",21
"10224","Jinora","F","10","11",21
"10227","Joline","F","10","11",21
"10267","Kelbi","F","10","11",21
"10281","Khiya","F","10","11",21
"10284","Kinslea","F","10","11",21
"10290","Konner","F","10","11",21
"10311","Leilanny","F","10","11",21
"10331","Lorien","F","10","11",21
"10337","Lylith","F","10","11",21
"10341","Lyrique","F","10","11",21
"10362","Mandi","F","10","11",21
"10371","Marleni","F","10","11",21
"10377","Masiyah","F","10","11",21
"10383","Mckaylee","F","10","11",21
"10384","Melenie","F","10","11",21
"10396","Montanna","F","10","11",21
"10409","Navah","F","10","11",21
"10425","Nyana","F","10","11",21
"10448","Quynn","F","10","11",21
"10452","Raley","F","10","11",21
"10459","Raylea","F","10","11",21
"10469","Rhya","F","10","11",21
"10480","Ryelee","F","10","11",21
"10486","Sadhana","F","10","11",21
"10502","Sherrie","F","10","11",21
"10505","Siddalee","F","10","11",21
"10511","Stela","F","10","11",21
"10516","Summit","F","10","11",21
"10532","Teddi","F","10","11",21
"10533","Teddie","F","10","11",21
"10557","Vyla","F","10","11",21
"10558","Waniya","F","10","11",21
"10564","Yarexi","F","10","11",21
"10566","Yarielys","F","10","11",21
"10567","Yaritzy","F","10","11",21
"10582","Zeeva","F","10","11",21
"10584","Zeniya","F","10","11",21
"10587","Zilah","F","10","11",21
"10628","Ailsa","F","9","12",21
"10653","Alyzabeth","F","9","12",21
"10691","Aquila","F","9","12",21
"10710","Avagail","F","9","12",21
"10738","Braedyn","F","9","12",21
"10784","Christel","F","9","12",21
"10791","Crystel","F","9","12",21
"10805","Danny","F","9","12",21
"10813","Deethya","F","9","12",21
"10854","Elody","F","9","12",21
"10918","Hendy","F","9","12",21
"10942","Ismerai","F","9","12",21
"10956","Jaleia","F","9","12",21
"10959","Jamesyn","F","9","12",21
"11031","Kaylanni","F","9","12",21
"11038","Kelbie","F","9","12",21
"11089","Lenix","F","9","12",21
"11143","Marilla","F","9","12",21
"11149","Mattisyn","F","9","12",21
"11155","Melea","F","9","12",21
"11192","Neysa","F","9","12",21
"11194","Nilani","F","9","12",21
"11201","Nusayba","F","9","12",21
"11221","Rahi","F","9","12",21
"11236","Rhyen","F","9","12",21
"11238","Riann","F","9","12",21
"11248","Rosaura","F","9","12",21
"11257","Sadye","F","9","12",21
"11258","Sagal","F","9","12",21
"11291","Sophiamarie","F","9","12",21
"11322","Teresita","F","9","12",21
"11325","Thanvi","F","9","12",21
"11340","Valeri","F","9","12",21
"11351","Winslet","F","9","12",21
"11362","Yilin","F","9","12",21
"11375","Zaylia","F","9","12",21
"11388","Aaradhana","F","8","13",21
"11426","Alexxis","F","8","13",21
"11584","Dalari","F","8","13",21
"11585","Dalayna","F","8","13",21
"11622","Edynn","F","8","13",21
"11625","Eisa","F","8","13",21
"11657","Evangelyne","F","8","13",21
"11667","Feven","F","8","13",21
"11678","Ghala","F","8","13",21
"11690","Haddy","F","8","13",21
"11693","Hanaa","F","8","13",21
"11698","Harvey","F","8","13",21
"11699","Hasna","F","8","13",21
"11702","Hazleigh","F","8","13",21
"11708","Hser","F","8","13",21
"11729","Jaimarie","F","8","13",21
"11752","Jaylaa","F","8","13",21
"11766","Jessah","F","8","13",21
"11799","Kaliope","F","8","13",21
"11864","Laurelai","F","8","13",21
"11970","Meri","F","8","13",21
"12010","Neave","F","8","13",21
"12035","Oluwatoni","F","8","13",21
"12075","Rihana","F","8","13",21
"12088","Rudy","F","8","13",21
"12097","Saidee","F","8","13",21
"12103","Santina","F","8","13",21
"12123","Shawn","F","8","13",21
"12131","Shireen","F","8","13",21
"12171","Teonna","F","8","13",21
"12223","Zavannah","F","8","13",21
"12234","Zohra","F","8","13",21
"12260","Adlie","F","7","14",21
"12297","Alyrica","F","7","14",21
"12355","Aveena","F","7","14",21
"12540","Genoveva","F","7","14",21
"12557","Halimah","F","7","14",21
"12832","Mariame","F","7","14",21
"12852","Meilin","F","7","14",21
"12937","Nyellie","F","7","14",21
"12979","Raissa","F","7","14",21
"13090","Tanishi","F","7","14",21
"13128","Wynnie","F","7","14",21
"13158","Zalynn","F","7","14",21
"13198","Adileny","F","6","15",21
"13223","Aleisa","F","6","15",21
"13363","Brittish","F","6","15",21
"13483","Emmalea","F","6","15",21
"13544","Henchy","F","6","15",21
"13566","Ivery","F","6","15",21
"13625","Kahlea","F","6","15",21
"13661","Katey","F","6","15",21
"13781","Maeson","F","6","15",21
"13966","Reylynn","F","6","15",21
"14005","Samah","F","6","15",21
"14149","Zetta","F","6","15",21
"14155","Zoiee","F","6","15",21
"14181","Abbygayle","F","5","16",21
"14207","Aitiana","F","5","16",21
"14212","Akua","F","5","16",21
"14606","Io","F","5","16",21
"7651","Britani","F","15","5",20
"7690","Deyanna","F","15","5",20
"7815","Makaia","F","15","5",20
"7851","Naraly","F","15","5",20
"7859","Nyemiah","F","15","5",20
"7982","Alese","F","14","6",20
"7988","Alyxandra","F","14","6",20
"7989","Amala","F","14","6",20
"7990","Amazin","F","14","6",20
"7994","Amoree","F","14","6",20
"8050","Cerena","F","14","6",20
"8059","Cortlynn","F","14","6",20
"8061","Daily","F","14","6",20
"8119","Issabelle","F","14","6",20
"8120","Iszabella","F","14","6",20
"8127","Jaleeyah","F","14","6",20
"8133","Janelis","F","14","6",20
"8137","Jasneet","F","14","6",20
"8159","Kailoni","F","14","6",20
"8178","Kerstin","F","14","6",20
"8213","Liannah","F","14","6",20
"8216","Lilu","F","14","6",20
"8228","Mailynn","F","14","6",20
"8274","Norielle","F","14","6",20
"8275","Nyiah","F","14","6",20
"8297","Roniyah","F","14","6",20
"8360","Tynley","F","14","6",20
"8394","Zuley","F","14","6",20
"8396","Zyniah","F","14","6",20
"8417","Akylah","F","13","7",20
"8418","Alaiza","F","13","7",20
"8515","Dennise","F","13","7",20
"8518","Deziyah","F","13","7",20
"8530","Edda","F","13","7",20
"8540","Elliett","F","13","7",20
"8549","Everlea","F","13","7",20
"8552","Faithe","F","13","7",20
"8586","Jahlia","F","13","7",20
"8603","Jerika","F","13","7",20
"8625","Kendallyn","F","13","7",20
"8634","Kylieann","F","13","7",20
"8667","Lyndie","F","13","7",20
"8675","Madonna","F","13","7",20
"8706","Milka","F","13","7",20
"8711","Momoka","F","13","7",20
"8718","Namiyah","F","13","7",20
"8739","Oluwatomisin","F","13","7",20
"8750","Peytyn","F","13","7",20
"8769","Rocklyn","F","13","7",20
"8771","Rubyann","F","13","7",20
"8840","Zamantha","F","13","7",20
"8849","Aalijah","F","12","8",20
"8868","Ahriya","F","12","8",20
"8873","Aizley","F","12","8",20
"8885","Aleysa","F","12","8",20
"8896","Ameelah","F","12","8",20
"8899","Amillya","F","12","8",20
"8913","Anslie","F","12","8",20
"8948","Baylea","F","12","8",20
"8949","Baylin","F","12","8",20
"8958","Breeanna","F","12","8",20
"8981","Cianni","F","12","8",20
"8992","Danette","F","12","8",20
"9008","Derin","F","12","8",20
"9025","Emira","F","12","8",20
"9027","Erial","F","12","8",20
"9035","Fancy","F","12","8",20
"9075","Jalayia","F","12","8",20
"9084","Jase","F","12","8",20
"9115","Kareli","F","12","8",20
"9146","Kiva","F","12","8",20
"9147","Konstance","F","12","8",20
"9152","Kyelle","F","12","8",20
"9158","Leeani","F","12","8",20
"9162","Leonela","F","12","8",20
"9165","Libni","F","12","8",20
"9180","Maddelynn","F","12","8",20
"9201","Marlynn","F","12","8",20
"9208","Mehak","F","12","8",20
"9211","Meridian","F","12","8",20
"9214","Merlyn","F","12","8",20
"9223","Naeemah","F","12","8",20
"9233","Nisreen","F","12","8",20
"9234","Noga","F","12","8",20
"9244","Pollyanna","F","12","8",20
"9265","Rmani","F","12","8",20
"9274","Saaya","F","12","8",20
"9295","Shalyn","F","12","8",20
"9323","Tulip","F","12","8",20
"9347","Zane","F","12","8",20
"9359","Aaleeyah","F","11","9",20
"9366","Aayushi","F","11","9",20
"9371","Adeleigh","F","11","9",20
"9380","Akela","F","11","9",20
"9384","Alandra","F","11","9",20
"9389","Alexza","F","11","9",20
"9393","Alonnah","F","11","9",20
"9402","Anabeth","F","11","9",20
"9406","Anaysha","F","11","9",20
"9415","Anthea","F","11","9",20
"9419","Aricela","F","11","9",20
"9432","Avaley","F","11","9",20
"9446","Beautifull","F","11","9",20
"9451","Braileigh","F","11","9",20
"9455","Braylea","F","11","9",20
"9461","Brooklee","F","11","9",20
"9463","Caelin","F","11","9",20
"9506","Darah","F","11","9",20
"9510","Davanee","F","11","9",20
"9523","Ditya","F","11","9",20
"9553","Ezme","F","11","9",20
"9580","Hidaya","F","11","9",20
"9588","Indiya","F","11","9",20
"9591","Irisa","F","11","9",20
"9604","Janelys","F","11","9",20
"9611","Jazalynn","F","11","9",20
"9647","Karigan","F","11","9",20
"9649","Karlina","F","11","9",20
"9650","Kary","F","11","9",20
"9654","Katelynne","F","11","9",20
"9659","Kaysha","F","11","9",20
"9667","Khalise","F","11","9",20
"9687","Kortlynn","F","11","9",20
"9688","Kripa","F","11","9",20
"9703","Lauralee","F","11","9",20
"9715","Leylany","F","11","9",20
"9725","Lissa","F","11","9",20
"9733","Madicyn","F","11","9",20
"9736","Maecyn","F","11","9",20
"9738","Mahaley","F","11","9",20
"9763","Megyn","F","11","9",20
"9764","Meilyn","F","11","9",20
"9765","Melaine","F","11","9",20
"9785","Naryiah","F","11","9",20
"9792","Nereyda","F","11","9",20
"9809","Nylia","F","11","9",20
"9812","Oliwia","F","11","9",20
"9820","Paislea","F","11","9",20
"9823","Pieper","F","11","9",20
"9824","Poet","F","11","9",20
"9826","Prapti","F","11","9",20
"9827","Preesha","F","11","9",20
"9837","Rashell","F","11","9",20
"9854","Sahari","F","11","9",20
"9857","Saila","F","11","9",20
"9861","Samriddhi","F","11","9",20
"9864","Sarae","F","11","9",20
"9867","Sarrinah","F","11","9",20
"9869","Sephira","F","11","9",20
"9874","Shari","F","11","9",20
"9887","Solomiya","F","11","9",20
"9891","Suheyla","F","11","9",20
"9909","Temprance","F","11","9",20
"9912","Teyah","F","11","9",20
"9927","Vitoria","F","11","9",20
"9951","Zaela","F","11","9",20
"9976","Adhara","F","10","10",20
"9988","Aizlyn","F","10","10",20
"9999","Allayna","F","10","10",20
"10001","Allina","F","10","10",20
"10031","Ariauna","F","10","10",20
"10038","Armiyah","F","10","10",20
"10040","Aryani","F","10","10",20
"10048","Avanelle","F","10","10",20
"10060","Betul","F","10","10",20
"10063","Blakleigh","F","10","10",20
"10068","Brigit","F","10","10",20
"10085","Ciena","F","10","10",20
"10091","Cressida","F","10","10",20
"10095","Daina","F","10","10",20
"10098","Dalarie","F","10","10",20
"10111","Dearia","F","10","10",20
"10114","Denyla","F","10","10",20
"10115","Deona","F","10","10",20
"10120","Dniyah","F","10","10",20
"10134","Ellionna","F","10","10",20
"10151","Flannery","F","10","10",20
"10159","Gracelee","F","10","10",20
"10172","Harriett","F","10","10",20
"10178","Hephzibah","F","10","10",20
"10183","Hopelynn","F","10","10",20
"10185","Idella","F","10","10",20
"10191","Ivah","F","10","10",20
"10194","Izza","F","10","10",20
"10211","Jaxson","F","10","10",20
"10225","Jochebed","F","10","10",20
"10229","Josaphine","F","10","10",20
"10243","Kaislyn","F","10","10",20
"10247","Kalysta","F","10","10",20
"10258","Kayelee","F","10","10",20
"10259","Kayleana","F","10","10",20
"10277","Khadeejah","F","10","10",20
"10292","Kritika","F","10","10",20
"10298","Lailoni","F","10","10",20
"10302","Larayah","F","10","10",20
"10305","Latrice","F","10","10",20
"10343","Mackinlee","F","10","10",20
"10344","Maclyn","F","10","10",20
"10354","Malala","F","10","10",20
"10358","Malee","F","10","10",20
"10382","Mazal","F","10","10",20
"10386","Metzli","F","10","10",20
"10389","Miki","F","10","10",20
"10394","Mirren","F","10","10",20
"10405","Nandana","F","10","10",20
"10414","Nelani","F","10","10",20
"10419","Nil","F","10","10",20
"10422","Niyanna","F","10","10",20
"10439","Peniel","F","10","10",20
"10447","Quinnly","F","10","10",20
"10467","Renly","F","10","10",20
"10471","Roan","F","10","10",20
"10474","Romani","F","10","10",20
"10475","Rosali","F","10","10",20
"10479","Ruba","F","10","10",20
"10481","Ryian","F","10","10",20
"10509","Spruha","F","10","10",20
"10512","Stuti","F","10","10",20
"10520","Syla","F","10","10",20
"10521","Syra","F","10","10",20
"10531","Tanvika","F","10","10",20
"10539","Thomas","F","10","10",20
"10554","Vina","F","10","10",20
"10559","Warda","F","10","10",20
"10576","Zakiyyah","F","10","10",20
"10579","Zannah","F","10","10",20
"10589","Zissel","F","10","10",20
"10591","Zoeh","F","10","10",20
"10592","Zorie","F","10","10",20
"10616","Ahlana","F","9","11",20
"10619","Ahmina","F","9","11",20
"10640","Aliha","F","9","11",20
"10652","Alyxandria","F","9","11",20
"10655","Amana","F","9","11",20
"10656","Amarachukwu","F","9","11",20
"10666","Amiera","F","9","11",20
"10668","Ammara","F","9","11",20
"10721","Azalyn","F","9","11",20
"10725","Baani","F","9","11",20
"10751","Brixley","F","9","11",20
"10772","Cashlyn","F","9","11",20
"10786","Clary","F","9","11",20
"10817","Demiah","F","9","11",20
"10848","Ellajane","F","9","11",20
"10904","Hartleigh","F","9","11",20
"10913","Heavenlyjoy","F","9","11",20
"10926","Icelynn","F","9","11",20
"10945","Itzayanna","F","9","11",20
"10946","Ivalee","F","9","11",20
"10990","Jilliana","F","9","11",20
"11010","Kalis","F","9","11",20
"11019","Karlynn","F","9","11",20
"11023","Karuna","F","9","11",20
"11028","Kattie","F","9","11",20
"11039","Keliyah","F","9","11",20
"11057","Kindall","F","9","11",20
"11058","Kinsly","F","9","11",20
"11097","Lilyannah","F","9","11",20
"11099","Lisanna","F","9","11",20
"11100","Livingston","F","9","11",20
"11115","Madalee","F","9","11",20
"11120","Maicee","F","9","11",20
"11142","Marijose","F","9","11",20
"11172","Mitra","F","9","11",20
"11176","Nadiah","F","9","11",20
"11177","Naja","F","9","11",20
"11178","Najla","F","9","11",20
"11179","Nakiah","F","9","11",20
"11182","Namiko","F","9","11",20
"11184","Nature","F","9","11",20
"11200","Nuala","F","9","11",20
"11214","Prakriti","F","9","11",20
"11237","Rhylei","F","9","11",20
"11241","Rinnah","F","9","11",20
"11253","Ryana","F","9","11",20
"11260","Sai","F","9","11",20
"11267","Samyukta","F","9","11",20
"11274","Shaddai","F","9","11",20
"11284","Simrah","F","9","11",20
"11315","Tam","F","9","11",20
"11326","Tiare","F","9","11",20
"11334","Ty","F","9","11",20
"11344","Vidalia","F","9","11",20
"11371","Zalina","F","9","11",20
"11392","Abra","F","8","12",20
"11396","Adamariz","F","8","12",20
"11397","Adamary","F","8","12",20
"11398","Addilyne","F","8","12",20
"11425","Alessandria","F","8","12",20
"11464","Arabell","F","8","12",20
"11476","Arrielle","F","8","12",20
"11479","Artemisia","F","8","12",20
"11526","Briya","F","8","12",20
"11545","Caryn","F","8","12",20
"11560","Cherrish","F","8","12",20
"11569","Clancy","F","8","12",20
"11574","Conner","F","8","12",20
"11579","Crystianna","F","8","12",20
"11628","Elianne","F","8","12",20
"11642","Emarosa","F","8","12",20
"11686","Grettell","F","8","12",20
"11691","Haidynn","F","8","12",20
"11714","Ilena","F","8","12",20
"11741","Janat","F","8","12",20
"11744","Janett","F","8","12",20
"11757","Jenan","F","8","12",20
"11763","Jerelyn","F","8","12",20
"11769","Jiayi","F","8","12",20
"11802","Kamaiya","F","8","12",20
"11804","Kamilia","F","8","12",20
"11810","Karalee","F","8","12",20
"11824","Keianna","F","8","12",20
"11827","Kelilah","F","8","12",20
"11839","Kingsleigh","F","8","12",20
"11870","Leenah","F","8","12",20
"11893","Lovelynn","F","8","12",20
"11922","Makyra","F","8","12",20
"11940","Mariko","F","8","12",20
"11957","Mauriah","F","8","12",20
"11973","Micheala","F","8","12",20
"11979","Mindel","F","8","12",20
"12060","Raychel","F","8","12",20
"12065","Reine","F","8","12",20
"12109","Savaya","F","8","12",20
"12149","Staley","F","8","12",20
"12151","Sukaina","F","8","12",20
"12182","Torianna","F","8","12",20
"12197","Wateen","F","8","12",20
"12209","Yissel","F","8","12",20
"12239","Aadvika","F","7","13",20
"12304","Amileah","F","7","13",20
"12382","Blakeli","F","7","13",20
"12420","Casie","F","7","13",20
"12528","Faviola","F","7","13",20
"12544","Ginna","F","7","13",20
"12554","Hadlyn","F","7","13",20
"12608","Janaiyah","F","7","13",20
"12623","Jazarah","F","7","13",20
"12655","Juliany","F","7","13",20
"12675","Kaniah","F","7","13",20
"12717","Khya","F","7","13",20
"12719","Khylei","F","7","13",20
"12727","Kiora","F","7","13",20
"12765","Layali","F","7","13",20
"12795","Loralee","F","7","13",20
"12836","Marliyah","F","7","13",20
"12880","Mkenzie","F","7","13",20
"12896","Najwa","F","7","13",20
"12914","Neyah","F","7","13",20
"12918","Nikol","F","7","13",20
"12923","Nira","F","7","13",20
"12936","Nyeli","F","7","13",20
"13022","Sanna","F","7","13",20
"13086","Tallia","F","7","13",20
"13106","Tonia","F","7","13",20
"13111","Tytianna","F","7","13",20
"13152","Yuritzy","F","7","13",20
"13167","Zurii","F","7","13",20
"13170","Zyion","F","7","13",20
"13216","Alaiia","F","6","14",20
"13345","Bentli","F","6","14",20
"13374","Camaya","F","6","14",20
"13383","Carlei","F","6","14",20
"13446","Donia","F","6","14",20
"13457","Eilis","F","6","14",20
"13522","Ghina","F","6","14",20
"13539","Haru","F","6","14",20
"13702","Kiki","F","6","14",20
"13828","Mellody","F","6","14",20
"13836","Milaina","F","6","14",20
"13954","Rasha","F","6","14",20
"13962","Reighn","F","6","14",20
"13978","Roniya","F","6","14",20
"14012","Sareena","F","6","14",20
"14039","Siahna","F","6","14",20
"14099","Valor","F","6","14",20
"14287","Ares","F","5","15",20
"14504","Emnet","F","5","15",20
"14527","Evvie","F","5","15",20
"14925","Mylo","F","5","15",20
"14956","Nerissa","F","5","15",20
"14965","Nimah","F","5","15",20
"8044","Camella","F","14","5",19
"8060","Coumba","F","14","5",19
"8071","Deandrea","F","14","5",19
"8089","Elmira","F","14","5",19
"8098","Esli","F","14","5",19
"8121","Jadence","F","14","5",19
"8181","Kevin","F","14","5",19
"8229","Makenize","F","14","5",19
"8235","Mariyana","F","14","5",19
"8316","Shelsy","F","14","5",19
"8337","Taila","F","14","5",19
"8351","Timiyah","F","14","5",19
"8405","Adianna","F","13","6",19
"8420","Aleanna","F","13","6",19
"8421","Aliveah","F","13","6",19
"8448","Ariea","F","13","6",19
"8466","Averyrose","F","13","6",19
"8487","Brinna","F","13","6",19
"8489","Caela","F","13","6",19
"8501","Collin","F","13","6",19
"8509","Danielys","F","13","6",19
"8510","Dava","F","13","6",19
"8524","Dolce","F","13","6",19
"8587","Jaiana","F","13","6",19
"8588","Jaidynn","F","13","6",19
"8594","Janique","F","13","6",19
"8600","Jennelle","F","13","6",19
"8624","Kelsei","F","13","6",19
"8702","Michel","F","13","6",19
"8716","Nalini","F","13","6",19
"8735","Nyeema","F","13","6",19
"8743","Paisely","F","13","6",19
"8775","Rylynne","F","13","6",19
"8790","Shakthi","F","13","6",19
"8792","Shamiah","F","13","6",19
"8856","Adan","F","12","7",19
"8865","Adylynn","F","12","7",19
"8866","Aerianna","F","12","7",19
"8901","Amyria","F","12","7",19
"8906","Andreah","F","12","7",19
"8960","Brice","F","12","7",19
"8961","Brightyn","F","12","7",19
"8978","Catori","F","12","7",19
"9004","Deleyza","F","12","7",19
"9031","Eugenie","F","12","7",19
"9043","Genavie","F","12","7",19
"9046","Gila","F","12","7",19
"9057","Hava","F","12","7",19
"9077","Jamaica","F","12","7",19
"9086","Jayceon","F","12","7",19
"9109","Kamarah","F","12","7",19
"9130","Kendi","F","12","7",19
"9145","Kinzly","F","12","7",19
"9149","Korea","F","12","7",19
"9153","Kyliana","F","12","7",19
"9155","Lailany","F","12","7",19
"9185","Mahreen","F","12","7",19
"9238","Onyinyechi","F","12","7",19
"9272","Saadia","F","12","7",19
"9285","Sarabella","F","12","7",19
"9287","Saraih","F","12","7",19
"9291","Seba","F","12","7",19
"9322","Trust","F","12","7",19
"9326","Tyrah","F","12","7",19
"9341","Yanitza","F","12","7",19
"9345","Zamariah","F","12","7",19
"9363","Aaryana","F","11","8",19
"9375","Aeriel","F","11","8",19
"9381","Akyla","F","11","8",19
"9407","Andalyn","F","11","8",19
"9414","Annalysa","F","11","8",19
"9416","Anzlee","F","11","8",19
"9422","Asenat","F","11","8",19
"9423","Aseneth","F","11","8",19
"9441","Azalya","F","11","8",19
"9449","Bessie","F","11","8",19
"9456","Braylei","F","11","8",19
"9465","Calayah","F","11","8",19
"9466","Caleb","F","11","8",19
"9467","Caleesi","F","11","8",19
"9469","Caliya","F","11","8",19
"9477","Cateleya","F","11","8",19
"9488","Chikaima","F","11","8",19
"9490","Ciani","F","11","8",19
"9502","Danila","F","11","8",19
"9518","Dessie","F","11","8",19
"9528","Dunia","F","11","8",19
"9567","Graylee","F","11","8",19
"9568","Gwyndolyn","F","11","8",19
"9572","Hanalei","F","11","8",19
"9592","Irys","F","11","8",19
"9600","Jaleiah","F","11","8",19
"9618","Jezabelle","F","11","8",19
"9624","Jonni","F","11","8",19
"9631","Kadi","F","11","8",19
"9632","Kaileen","F","11","8",19
"9635","Kaithlyn","F","11","8",19
"9660","Kaytlynn","F","11","8",19
"9666","Kestrel","F","11","8",19
"9675","Kimberlie","F","11","8",19
"9680","Kionna","F","11","8",19
"9684","Koa","F","11","8",19
"9706","Leani","F","11","8",19
"9718","Lillymae","F","11","8",19
"9735","Madysyn","F","11","8",19
"9754","Maryori","F","11","8",19
"9758","Mayela","F","11","8",19
"9760","Maylanie","F","11","8",19
"9769","Michelina","F","11","8",19
"9778","Morelia","F","11","8",19
"9816","Orchid","F","11","8",19
"9819","Owynn","F","11","8",19
"9822","Persephonie","F","11","8",19
"9838","Reggie","F","11","8",19
"9845","Rilla","F","11","8",19
"9846","Rosamund","F","11","8",19
"9849","Ruqaya","F","11","8",19
"9859","Samika","F","11","8",19
"9866","Sareen","F","11","8",19
"9870","Seylah","F","11","8",19
"9873","Shannel","F","11","8",19
"9899","Talisa","F","11","8",19
"9904","Taylan","F","11","8",19
"9925","Victorya","F","11","8",19
"9944","Yena","F","11","8",19
"9946","Yoona","F","11","8",19
"9969","Adamae","F","10","9",19
"9983","Ahmira","F","10","9",19
"9990","Alanii","F","10","9",19
"9993","Aleighna","F","10","9",19
"10000","Allia","F","10","9",19
"10007","Ameira","F","10","9",19
"10028","Annica","F","10","9",19
"10033","Arieonna","F","10","9",19
"10045","Aubery","F","10","9",19
"10051","Axelle","F","10","9",19
"10053","Azaylah","F","10","9",19
"10054","Azhar","F","10","9",19
"10076","Cassidie","F","10","9",19
"10080","Chanie","F","10","9",19
"10083","Chi","F","10","9",19
"10096","Daisymae","F","10","9",19
"10155","Gayatri","F","10","9",19
"10169","Halena","F","10","9",19
"10170","Halynn","F","10","9",19
"10181","Hilde","F","10","9",19
"10186","Ileanna","F","10","9",19
"10197","Jahdai","F","10","9",19
"10202","Jakari","F","10","9",19
"10218","Jazzelle","F","10","9",19
"10221","Jessilyn","F","10","9",19
"10234","Juli","F","10","9",19
"10241","Kahealani","F","10","9",19
"10248","Kammie","F","10","9",19
"10249","Kandis","F","10","9",19
"10278","Khalea","F","10","9",19
"10303","Larose","F","10","9",19
"10314","Lianah","F","10","9",19
"10317","Lillah","F","10","9",19
"10318","Lillyona","F","10","9",19
"10319","Lillyth","F","10","9",19
"10340","Lyrick","F","10","9",19
"10345","Maddisen","F","10","9",19
"10352","Mala","F","10","9",19
"10364","Margarette","F","10","9",19
"10369","Marlaya","F","10","9",19
"10378","Matilynn","F","10","9",19
"10398","Mylynn","F","10","9",19
"10403","Nakyla","F","10","9",19
"10406","Nasteho","F","10","9",19
"10418","Niema","F","10","9",19
"10435","Parthenia","F","10","9",19
"10454","Rateel","F","10","9",19
"10468","Rhealynn","F","10","9",19
"10491","Sarahgrace","F","10","9",19
"10493","Seana","F","10","9",19
"10498","Sharvi","F","10","9",19
"10517","Sunniva","F","10","9",19
"10543","Torryn","F","10","9",19
"10550","Vallerie","F","10","9",19
"10561","Xela","F","10","9",19
"10572","Yuliet","F","10","9",19
"10581","Zea","F","10","9",19
"10583","Zehava","F","10","9",19
"10588","Zineb","F","10","9",19
"10610","Adrienna","F","9","10",19
"10613","Africa","F","9","10",19
"10638","Aleynah","F","9","10",19
"10654","Alyzza","F","9","10",19
"10657","Amarilis","F","9","10",19
"10660","Ameli","F","9","10",19
"10670","Analeyah","F","9","10",19
"10680","Anjelina","F","9","10",19
"10684","Annalaya","F","9","10",19
"10695","Ariannie","F","9","10",19
"10701","Armahni","F","9","10",19
"10706","Ashli","F","9","10",19
"10714","Avilyn","F","9","10",19
"10717","Avlynn","F","9","10",19
"10723","Azealia","F","9","10",19
"10735","Blaklee","F","9","10",19
"10744","Brighid","F","9","10",19
"10755","Bryli","F","9","10",19
"10764","Cambryn","F","9","10",19
"10803","Daniyla","F","9","10",19
"10804","Dannica","F","9","10",19
"10815","Deleah","F","9","10",19
"10821","Despina","F","9","10",19
"10839","Elania","F","9","10",19
"10850","Ellianne","F","9","10",19
"10853","Elloree","F","9","10",19
"10856","Elyce","F","9","10",19
"10857","Elyna","F","9","10",19
"10866","Emmry","F","9","10",19
"10868","Eriyah","F","9","10",19
"10875","Evangelynn","F","9","10",19
"10879","Ewa","F","9","10",19
"10884","Findley","F","9","10",19
"10907","Hatley","F","9","10",19
"10912","Hazzel","F","9","10",19
"10931","Ilsa","F","9","10",19
"10936","Isabellarose","F","9","10",19
"10948","Jaeden","F","9","10",19
"10953","Jaielle","F","9","10",19
"10983","Jerusha","F","9","10",19
"10995","Joei","F","9","10",19
"10997","Jolyn","F","9","10",19
"11006","Juneau","F","9","10",19
"11013","Kamala","F","9","10",19
"11030","Kayani","F","9","10",19
"11041","Kena","F","9","10",19
"11048","Khadeeja","F","9","10",19
"11077","Lanasia","F","9","10",19
"11078","Landen","F","9","10",19
"11079","Lanee","F","9","10",19
"11084","Latifa","F","9","10",19
"11092","Lexee","F","9","10",19
"11094","Liliahna","F","9","10",19
"11095","Liliani","F","9","10",19
"11119","Mahrosh","F","9","10",19
"11129","Makinleigh","F","9","10",19
"11160","Meritt","F","9","10",19
"11171","Missy","F","9","10",19
"11175","Muslima","F","9","10",19
"11204","Oceane","F","9","10",19
"11213","Poetry","F","9","10",19
"11216","Quetzally","F","9","10",19
"11223","Raiza","F","9","10",19
"11233","Rhegan","F","9","10",19
"11242","Riot","F","9","10",19
"11245","Roizy","F","9","10",19
"11246","Rola","F","9","10",19
"11266","Samyiah","F","9","10",19
"11269","Santanna","F","9","10",19
"11271","Sare","F","9","10",19
"11272","Secilia","F","9","10",19
"11273","Selia","F","9","10",19
"11302","Sultana","F","9","10",19
"11305","Suriya","F","9","10",19
"11306","Suriyah","F","9","10",19
"11329","Tiona","F","9","10",19
"11335","Tzippy","F","9","10",19
"11365","Yudith","F","9","10",19
"11372","Zanae","F","9","10",19
"11374","Zawadi","F","9","10",19
"11378","Zeta","F","9","10",19
"11406","Adlynn","F","8","11",19
"11444","Amrutha","F","8","11",19
"11451","Andreanna","F","8","11",19
"11456","Annalena","F","8","11",19
"11462","Aoi","F","8","11",19
"11481","Asal","F","8","11",19
"11492","Atleigh","F","8","11",19
"11519","Breighlyn","F","8","11",19
"11546","Cashlynn","F","8","11",19
"11547","Cassady","F","8","11",19
"11605","Demaya","F","8","11",19
"11611","Diamonique","F","8","11",19
"11617","Dreyah","F","8","11",19
"11630","Eliz","F","8","11",19
"11664","Farzona","F","8","11",19
"11665","Fayelynn","F","8","11",19
"11669","Gabbie","F","8","11",19
"11682","Glenna","F","8","11",19
"11688","Gurbani","F","8","11",19
"11689","Gwendalynn","F","8","11",19
"11734","Jaleeah","F","8","11",19
"11781","Jordie","F","8","11",19
"11785","Jrue","F","8","11",19
"11797","Kalanie","F","8","11",19
"11809","Kanna","F","8","11",19
"11826","Keliana","F","8","11",19
"11866","Lavaeh","F","8","11",19
"11881","Libi","F","8","11",19
"11887","Lindsy","F","8","11",19
"11895","Lucielle","F","8","11",19
"11896","Luke","F","8","11",19
"11902","Lyrah","F","8","11",19
"11907","Madiha","F","8","11",19
"11919","Makaylynn","F","8","11",19
"11942","Marivel","F","8","11",19
"11950","Marylyn","F","8","11",19
"11952","Marzia","F","8","11",19
"11954","Massiel","F","8","11",19
"11956","Mattalynn","F","8","11",19
"11978","Milaysia","F","8","11",19
"11983","Misaki","F","8","11",19
"11988","Mubina","F","8","11",19
"11995","Nadezhda","F","8","11",19
"12004","Nataliyah","F","8","11",19
"12008","Nayvee","F","8","11",19
"12011","Nehemie","F","8","11",19
"12024","Nithila","F","8","11",19
"12058","Rakiya","F","8","11",19
"12061","Raylei","F","8","11",19
"12062","Rayvin","F","8","11",19
"12080","Ronin","F","8","11",19
"12105","Sarahann","F","8","11",19
"12107","Sarya","F","8","11",19
"12113","Seraiah","F","8","11",19
"12121","Sharla","F","8","11",19
"12124","Shawnee","F","8","11",19
"12137","Siyana","F","8","11",19
"12160","Taara","F","8","11",19
"12176","Terry","F","8","11",19
"12185","Trinnity","F","8","11",19
"12191","Venecia","F","8","11",19
"12204","Yamina","F","8","11",19
"12218","Zalea","F","8","11",19
"12361","Aylanie","F","7","12",19
"12436","Cortlyn","F","7","12",19
"12455","Delayne","F","7","12",19
"12467","Dezlyn","F","7","12",19
"12478","Edythe","F","7","12",19
"12496","Ellorie","F","7","12",19
"12534","Gabriana","F","7","12",19
"12568","Honestie","F","7","12",19
"12581","Ishitha","F","7","12",19
"12638","Jiaqi","F","7","12",19
"12649","Josee","F","7","12",19
"12666","Kailiana","F","7","12",19
"12671","Kamarii","F","7","12",19
"12730","Kiylee","F","7","12",19
"12732","Kmari","F","7","12",19
"12761","Lauretta","F","7","12",19
"12771","Lenya","F","7","12",19
"12819","Makailah","F","7","12",19
"12827","Maley","F","7","12",19
"12861","Meryn","F","7","12",19
"12908","Nazariah","F","7","12",19
"12956","Paiten","F","7","12",19
"12966","Posie","F","7","12",19
"12974","Raea","F","7","12",19
"12999","Rosealyn","F","7","12",19
"13019","Samreet","F","7","12",19
"13040","Setayesh","F","7","12",19
"13124","Wells","F","7","12",19
"13162","Zarrah","F","7","12",19
"13250","Amalee","F","6","13",19
"13347","Bettina","F","6","13",19
"13382","Caren","F","6","13",19
"13610","Jocabed","F","6","13",19
"13698","Khiana","F","6","13",19
"13740","Lavonna","F","6","13",19
"13764","Lunah","F","6","13",19
"13797","Malu","F","6","13",19
"13826","Melinna","F","6","13",19
"13849","Molleigh","F","6","13",19
"13885","Nazanin","F","6","13",19
"13979","Roosevelt","F","6","13",19
"14182","Abia","F","5","14",19
"14199","Ahnika","F","5","14",19
"14333","Ayris","F","5","14",19
"14488","Ellisa","F","5","14",19
"14772","Krishika","F","5","14",19
"14799","Legacee","F","5","14",19
"14838","Macklynn","F","5","14",19
"14911","Milca","F","5","14",19
"14929","Nahiara","F","5","14",19
"15156","Thia","F","5","14",19
"15196","Xiamara","F","5","14",19
"8419","Alan","F","13","5",18
"8462","Autry","F","13","5",18
"8486","Briell","F","13","5",18
"8506","Daliya","F","13","5",18
"8536","Elenie","F","13","5",18
"8585","Jahara","F","13","5",18
"8595","Jaydan","F","13","5",18
"8647","Leea","F","13","5",18
"8696","Meiling","F","13","5",18
"8697","Melat","F","13","5",18
"8704","Mikela","F","13","5",18
"8721","Nataya","F","13","5",18
"8798","Siani","F","13","5",18
"8818","Tionne","F","13","5",18
"8854","Adalis","F","12","6",18
"8870","Aileana","F","12","6",18
"8916","Anwen","F","12","6",18
"8928","Aubrina","F","12","6",18
"8929","Aubrynn","F","12","6",18
"8952","Bethanny","F","12","6",18
"8963","Bristyl","F","12","6",18
"8989","Dalaya","F","12","6",18
"8998","Daylyn","F","12","6",18
"9003","Delaynie","F","12","6",18
"9006","Demiana","F","12","6",18
"9017","Elianie","F","12","6",18
"9021","Ellyssa","F","12","6",18
"9041","Galina","F","12","6",18
"9050","Grethel","F","12","6",18
"9051","Haidee","F","12","6",18
"9082","Janita","F","12","6",18
"9094","Jerney","F","12","6",18
"9095","Jeselle","F","12","6",18
"9097","Jniyah","F","12","6",18
"9106","Kaleeah","F","12","6",18
"9108","Kamalani","F","12","6",18
"9120","Kathaleya","F","12","6",18
"9125","Keiley","F","12","6",18
"9129","Kendel","F","12","6",18
"9143","Kilah","F","12","6",18
"9154","Kynadi","F","12","6",18
"9178","Mackenize","F","12","6",18
"9189","Makaylyn","F","12","6",18
"9219","Mikella","F","12","6",18
"9220","Milanna","F","12","6",18
"9228","Nazly","F","12","6",18
"9240","Ovi","F","12","6",18
"9241","Paiden","F","12","6",18
"9247","Prosperity","F","12","6",18
"9268","Rosana","F","12","6",18
"9269","Rosealee","F","12","6",18
"9292","Seher","F","12","6",18
"9303","Soffia","F","12","6",18
"9309","Taia","F","12","6",18
"9313","Teliyah","F","12","6",18
"9334","Ward","F","12","6",18
"9352","Zhoe","F","12","6",18
"9356","Aaisha","F","11","7",18
"9361","Aarielle","F","11","7",18
"9362","Aariyana","F","11","7",18
"9383","Alaira","F","11","7",18
"9386","Aleese","F","11","7",18
"9399","Amanii","F","11","7",18
"9403","Anahli","F","11","7",18
"9412","Annabellee","F","11","7",18
"9439","Ayrianna","F","11","7",18
"9444","Azmina","F","11","7",18
"9450","Braeley","F","11","7",18
"9452","Braley","F","11","7",18
"9484","Channel","F","11","7",18
"9486","Cherysh","F","11","7",18
"9499","Daizee","F","11","7",18
"9517","Demri","F","11","7",18
"9526","Donya","F","11","7",18
"9527","Drishti","F","11","7",18
"9541","Emberlin","F","11","7",18
"9549","Esti","F","11","7",18
"9557","Fynleigh","F","11","7",18
"9558","Gabriell","F","11","7",18
"9565","Gita","F","11","7",18
"9574","Haydyn","F","11","7",18
"9576","Hazelee","F","11","7",18
"9590","Irianna","F","11","7",18
"9594","Ivylynn","F","11","7",18
"9601","Jalene","F","11","7",18
"9602","Jalise","F","11","7",18
"9606","Janyia","F","11","7",18
"9607","Jasslyn","F","11","7",18
"9629","Julliana","F","11","7",18
"9630","Jurney","F","11","7",18
"9637","Kaleiyah","F","11","7",18
"9639","Kallen","F","11","7",18
"9645","Kandi","F","11","7",18
"9657","Kaydince","F","11","7",18
"9665","Kessa","F","11","7",18
"9676","Kimiya","F","11","7",18
"9711","Lennex","F","11","7",18
"9746","Mansirat","F","11","7",18
"9762","Meeah","F","11","7",18
"9766","Mellany","F","11","7",18
"9771","Mikiah","F","11","7",18
"9780","Mylea","F","11","7",18
"9781","Nadalynn","F","11","7",18
"9782","Naeema","F","11","7",18
"9791","Nerea","F","11","7",18
"9806","Nyarai","F","11","7",18
"9835","Ranae","F","11","7",18
"9852","Sada","F","11","7",18
"9860","Sammantha","F","11","7",18
"9872","Shanley","F","11","7",18
"9890","Steele","F","11","7",18
"9918","Vannah","F","11","7",18
"9930","Winner","F","11","7",18
"9936","Yalini","F","11","7",18
"9940","Yareth","F","11","7",18
"9965","Abeer","F","10","8",18
"9980","Aerie","F","10","8",18
"9995","Aleksia","F","10","8",18
"10004","Amarys","F","10","8",18
"10021","Angelys","F","10","8",18
"10024","Ankita","F","10","8",18
"10027","Annalyssa","F","10","8",18
"10044","Atlantis","F","10","8",18
"10058","Beckley","F","10","8",18
"10071","Caiyah","F","10","8",18
"10084","Chyler","F","10","8",18
"10087","Collier","F","10","8",18
"10112","Delayni","F","10","8",18
"10133","Elliannah","F","10","8",18
"10138","Emmajane","F","10","8",18
"10141","Enslee","F","10","8",18
"10160","Graciana","F","10","8",18
"10174","Haydn","F","10","8",18
"10177","Henya","F","10","8",18
"10187","Ilee","F","10","8",18
"10199","Jaidy","F","10","8",18
"10212","Jayceona","F","10","8",18
"10213","Jayelle","F","10","8",18
"10215","Jayleene","F","10","8",18
"10222","Jesus","F","10","8",18
"10246","Kaly","F","10","8",18
"10254","Kataleia","F","10","8",18
"10255","Kati","F","10","8",18
"10265","Keerthi","F","10","8",18
"10270","Kemiya","F","10","8",18
"10271","Kendahl","F","10","8",18
"10287","Klee","F","10","8",18
"10301","Lannah","F","10","8",18
"10308","Leahmarie","F","10","8",18
"10309","Leala","F","10","8",18
"10323","Liseth","F","10","8",18
"10325","Liyat","F","10","8",18
"10327","Liylah","F","10","8",18
"10329","Loany","F","10","8",18
"10339","Lynzi","F","10","8",18
"10348","Maire","F","10","8",18
"10350","Makaiya","F","10","8",18
"10368","Marlana","F","10","8",18
"10370","Marleah","F","10","8",18
"10393","Miriah","F","10","8",18
"10404","Nalina","F","10","8",18
"10408","Natanya","F","10","8",18
"10410","Naveyah","F","10","8",18
"10415","Nema","F","10","8",18
"10429","Oceanna","F","10","8",18
"10437","Payzlie","F","10","8",18
"10444","Prajna","F","10","8",18
"10451","Raiyah","F","10","8",18
"10457","Raye","F","10","8",18
"10472","Rodina","F","10","8",18
"10476","Rozalia","F","10","8",18
"10485","Sabriya","F","10","8",18
"10488","Sahiba","F","10","8",18
"10494","Sebrina","F","10","8",18
"10496","Shaden","F","10","8",18
"10497","Shadow","F","10","8",18
"10518","Surya","F","10","8",18
"10522","Taeya","F","10","8",18
"10524","Talasia","F","10","8",18
"10526","Talise","F","10","8",18
"10530","Tamzyn","F","10","8",18
"10536","Tereza","F","10","8",18
"10538","Thaleia","F","10","8",18
"10565","Yarieliz","F","10","8",18
"10597","Aalaysia","F","9","9",18
"10605","Adalise","F","9","9",18
"10636","Aleshka","F","9","9",18
"10637","Alexsia","F","9","9",18
"10647","Allyna","F","9","9",18
"10649","Alyena","F","9","9",18
"10661","Amelianna","F","9","9",18
"10677","Angelle","F","9","9",18
"10686","Annaston","F","9","9",18
"10720","Azaliyah","F","9","9",18
"10729","Beryl","F","9","9",18
"10734","Bianey","F","9","9",18
"10752","Brycelynn","F","9","9",18
"10757","Bryonna","F","9","9",18
"10775","Cayli","F","9","9",18
"10776","Celestial","F","9","9",18
"10794","Cyriah","F","9","9",18
"10799","Damara","F","9","9",18
"10806","Danyah","F","9","9",18
"10809","Dashley","F","9","9",18
"10811","Davine","F","9","9",18
"10820","Denice","F","9","9",18
"10846","Elisse","F","9","9",18
"10847","Elke","F","9","9",18
"10849","Ellenora","F","9","9",18
"10852","Ellinore","F","9","9",18
"10877","Evarose","F","9","9",18
"10883","Ferris","F","9","9",18
"10888","Gianina","F","9","9",18
"10889","Gilda","F","9","9",18
"10892","Gracieann","F","9","9",18
"10895","Hadyn","F","9","9",18
"10901","Hanaan","F","9","9",18
"10902","Hanifa","F","9","9",18
"10920","Henlie","F","9","9",18
"10922","Hikma","F","9","9",18
"10927","Ikram","F","9","9",18
"10930","Illeana","F","9","9",18
"10940","Isella","F","9","9",18
"10947","Izamar","F","9","9",18
"10962","Jamyrah","F","9","9",18
"10967","Jasiel","F","9","9",18
"10980","Jeri","F","9","9",18
"10988","Jhanvi","F","9","9",18
"10993","Jocee","F","9","9",18
"11017","Karielle","F","9","9",18
"11018","Karinna","F","9","9",18
"11060","Kleo","F","9","9",18
"11062","Kosisochukwu","F","9","9",18
"11064","Kriya","F","9","9",18
"11066","Kyani","F","9","9",18
"11067","Kyann","F","9","9",18
"11071","Laianna","F","9","9",18
"11073","Laini","F","9","9",18
"11076","Lala","F","9","9",18
"11080","Lanier","F","9","9",18
"11087","Laylonnie","F","9","9",18
"11088","Lazariah","F","9","9",18
"11096","Lilliona","F","9","9",18
"11103","Loni","F","9","9",18
"11109","Loza","F","9","9",18
"11110","Lucette","F","9","9",18
"11113","Lynniah","F","9","9",18
"11114","Lynzee","F","9","9",18
"11125","Makailyn","F","9","9",18
"11135","Malory","F","9","9",18
"11151","Mavery","F","9","9",18
"11157","Meliya","F","9","9",18
"11183","Naomii","F","9","9",18
"11187","Ndeye","F","9","9",18
"11203","Oasis","F","9","9",18
"11205","Oliana","F","9","9",18
"11207","Omni","F","9","9",18
"11208","Oni","F","9","9",18
"11220","Rafeef","F","9","9",18
"11239","Rigby","F","9","9",18
"11261","Saima","F","9","9",18
"11282","Silas","F","9","9",18
"11285","Sita","F","9","9",18
"11293","Soul","F","9","9",18
"11309","Symphonie","F","9","9",18
"11311","Taetum","F","9","9",18
"11313","Taleya","F","9","9",18
"11314","Talulla","F","9","9",18
"11328","Tilden","F","9","9",18
"11341","Veida","F","9","9",18
"11368","Zaelee","F","9","9",18
"11382","Zyann","F","9","9",18
"11394","Adalai","F","8","10",18
"11410","Afsheen","F","8","10",18
"11418","Ajooni","F","8","10",18
"11429","Aliany","F","8","10",18
"11431","Alithea","F","8","10",18
"11441","Amiee","F","8","10",18
"11461","Anyela","F","8","10",18
"11463","Apolline","F","8","10",18
"11465","Aracelli","F","8","10",18
"11473","Arlington","F","8","10",18
"11477","Arrington","F","8","10",18
"11478","Arshika","F","8","10",18
"11487","Atalaya","F","8","10",18
"11502","Avya","F","8","10",18
"11511","Baylyn","F","8","10",18
"11529","Bronte","F","8","10",18
"11555","Charlieann","F","8","10",18
"11572","Cobi","F","8","10",18
"11581","Daiya","F","8","10",18
"11610","Deztiny","F","8","10",18
"11619","Ebunoluwa","F","8","10",18
"11629","Elisheba","F","8","10",18
"11634","Elliemay","F","8","10",18
"11637","Elmina","F","8","10",18
"11639","Elyanah","F","8","10",18
"11656","Evalie","F","8","10",18
"11658","Evlynn","F","8","10",18
"11680","Giuliette","F","8","10",18
"11701","Hazeleigh","F","8","10",18
"11706","Hiliana","F","8","10",18
"11717","Iremide","F","8","10",18
"11718","Irish","F","8","10",18
"11720","Isobella","F","8","10",18
"11727","Jaidence","F","8","10",18
"11733","Jakylah","F","8","10",18
"11760","Jenisha","F","8","10",18
"11773","Jiyah","F","8","10",18
"11774","Jocilyn","F","8","10",18
"11784","Joylynn","F","8","10",18
"11807","Kandyce","F","8","10",18
"11815","Kasiyah","F","8","10",18
"11823","Keena","F","8","10",18
"11840","Kinzi","F","8","10",18
"11847","Kourtni","F","8","10",18
"11888","Linsy","F","8","10",18
"11890","Lonna","F","8","10",18
"11899","Luxe","F","8","10",18
"11908","Madinah","F","8","10",18
"11909","Maebree","F","8","10",18
"11913","Mahek","F","8","10",18
"11917","Makari","F","8","10",18
"11918","Makaylie","F","8","10",18
"11935","Marialuisa","F","8","10",18
"11936","Mariapaula","F","8","10",18
"11937","Mariavictoria","F","8","10",18
"11945","Marriah","F","8","10",18
"11960","Mayim","F","8","10",18
"11967","Mel","F","8","10",18
"11972","Miaya","F","8","10",18
"11981","Mirely","F","8","10",18
"11984","Miyu","F","8","10",18
"11989","Muntas","F","8","10",18
"12029","Nyemah","F","8","10",18
"12032","Nyna","F","8","10",18
"12042","Prachi","F","8","10",18
"12043","Pranika","F","8","10",18
"12051","Raela","F","8","10",18
"12054","Raima","F","8","10",18
"12056","Rakeb","F","8","10",18
"12059","Ramey","F","8","10",18
"12066","Rejoice","F","8","10",18
"12070","Rhilyn","F","8","10",18
"12106","Saraiya","F","8","10",18
"12126","Shayleen","F","8","10",18
"12163","Talena","F","8","10",18
"12181","Tilia","F","8","10",18
"12183","Tove","F","8","10",18
"12207","Yazlyn","F","8","10",18
"12226","Zema","F","8","10",18
"12227","Zera","F","8","10",18
"12236","Zurri","F","8","10",18
"12240","Aaila","F","7","11",18
"12244","Aashika","F","7","11",18
"12266","Afifa","F","7","11",18
"12271","Ahmiracle","F","7","11",18
"12276","Ahonesty","F","7","11",18
"12289","Alanee","F","7","11",18
"12298","Amaal","F","7","11",18
"12307","Amma","F","7","11",18
"12312","Anastasija","F","7","11",18
"12323","Annalyce","F","7","11",18
"12330","Aracelis","F","7","11",18
"12357","Avilene","F","7","11",18
"12367","Azel","F","7","11",18
"12398","Briona","F","7","11",18
"12406","Brynlei","F","7","11",18
"12426","Charlierose","F","7","11",18
"12440","Dailah","F","7","11",18
"12462","Desarae","F","7","11",18
"12469","Draizy","F","7","11",18
"12484","Elaynah","F","7","11",18
"12524","Faizah","F","7","11",18
"12529","Fenix","F","7","11",18
"12531","Fortune","F","7","11",18
"12577","Ionna","F","7","11",18
"12601","Jaloni","F","7","11",18
"12617","Jaryah","F","7","11",18
"12625","Jazyiah","F","7","11",18
"12643","Johnny","F","7","11",18
"12662","Kaede","F","7","11",18
"12669","Kalisa","F","7","11",18
"12728","Kirstin","F","7","11",18
"12757","Laraya","F","7","11",18
"12767","Leddy","F","7","11",18
"12773","Leslye","F","7","11",18
"12789","Lizandra","F","7","11",18
"12799","Luann","F","7","11",18
"12823","Makyia","F","7","11",18
"12844","Maymuna","F","7","11",18
"12854","Melaya","F","7","11",18
"12865","Mickaela","F","7","11",18
"12869","Mileidy","F","7","11",18
"12892","Nadja","F","7","11",18
"12900","Nali","F","7","11",18
"12948","Oralia","F","7","11",18
"12960","Pax","F","7","11",18
"12967","Pranisha","F","7","11",18
"12989","Renatha","F","7","11",18
"12990","Renlee","F","7","11",18
"13014","Salayah","F","7","11",18
"13029","Saralynn","F","7","11",18
"13048","Shine","F","7","11",18
"13081","Sylvanna","F","7","11",18
"13130","Xin","F","7","11",18
"13205","Adrika","F","6","12",18
"13243","Alonnie","F","6","12",18
"13265","Amyrie","F","6","12",18
"13278","Aneri","F","6","12",18
"13343","Bemnet","F","6","12",18
"13344","Bennie","F","6","12",18
"13377","Camielle","F","6","12",18
"13395","Chani","F","6","12",18
"13477","Emberli","F","6","12",18
"13503","Fatimazahra","F","6","12",18
"13511","Fox","F","6","12",18
"13621","Justis","F","6","12",18
"13623","Kaegan","F","6","12",18
"13652","Karlin","F","6","12",18
"13656","Karyssa","F","6","12",18
"13678","Keli","F","6","12",18
"13784","Mahogani","F","6","12",18
"13798","Manessa","F","6","12",18
"13986","Rukia","F","6","12",18
"13995","Sadiemae","F","6","12",18
"14054","Sophiana","F","6","12",18
"14134","Yuritza","F","6","12",18
"14135","Yutong","F","6","12",18
"14316","Audreyana","F","5","13",18
"14337","Azelea","F","5","13",18
"14417","Czarina","F","5","13",18
"14421","Dailey","F","5","13",18
"14624","Jahari","F","5","13",18
"14704","Kaileia","F","5","13",18
"14710","Kamaree","F","5","13",18
"14746","Khailee","F","5","13",18
"14771","Kota","F","5","13",18
"14820","Loriel","F","5","13",18
"15154","Thaily","F","5","13",18
"15168","Trishika","F","5","13",18
"15238","Zaylani","F","5","13",18
"15258","Ziyon","F","5","13",18
"8864","Adylyn","F","12","5",17
"8877","Alailah","F","12","5",17
"8884","Alexya","F","12","5",17
"8887","Alicea","F","12","5",17
"8892","Allanna","F","12","5",17
"8907","Andrianna","F","12","5",17
"8915","Antionette","F","12","5",17
"8943","Aymee","F","12","5",17
"8964","Brittain","F","12","5",17
"8969","Calais","F","12","5",17
"8972","Calyssa","F","12","5",17
"8974","Carisa","F","12","5",17
"8993","Danity","F","12","5",17
"9019","Ellisen","F","12","5",17
"9029","Estefanny","F","12","5",17
"9060","Henzley","F","12","5",17
"9081","Janee","F","12","5",17
"9090","Jeilani","F","12","5",17
"9098","Joannah","F","12","5",17
"9103","Juliani","F","12","5",17
"9107","Kalisi","F","12","5",17
"9157","Latisha","F","12","5",17
"9206","Mckaela","F","12","5",17
"9252","Ramaya","F","12","5",17
"9270","Rosibel","F","12","5",17
"9276","Sacha","F","12","5",17
"9289","Sarra","F","12","5",17
"9305","Starling","F","12","5",17
"9314","Terriyah","F","12","5",17
"9317","Timea","F","12","5",17
"9367","Abeera","F","11","6",17
"9391","Allisen","F","11","6",17
"9413","Annalucia","F","11","6",17
"9421","Arzu","F","11","6",17
"9443","Azelle","F","11","6",17
"9472","Caralina","F","11","6",17
"9474","Cariyah","F","11","6",17
"9475","Carlena","F","11","6",17
"9480","Celest","F","11","6",17
"9483","Channah","F","11","6",17
"9508","Daryana","F","11","6",17
"9522","Dhrithi","F","11","6",17
"9529","Dusti","F","11","6",17
"9530","Dylanie","F","11","6",17
"9531","Effy","F","11","6",17
"9535","Eliyanna","F","11","6",17
"9554","Ezmerelda","F","11","6",17
"9575","Haylea","F","11","6",17
"9605","Jannet","F","11","6",17
"9616","Jeorgia","F","11","6",17
"9617","Jeraldine","F","11","6",17
"9638","Kalese","F","11","6",17
"9651","Kaselyn","F","11","6",17
"9671","Khloi","F","11","6",17
"9674","Kimberli","F","11","6",17
"9686","Kornelia","F","11","6",17
"9695","Kynsli","F","11","6",17
"9697","Laelani","F","11","6",17
"9700","Lanita","F","11","6",17
"9704","Lauralye","F","11","6",17
"9707","Legna","F","11","6",17
"9708","Leisel","F","11","6",17
"9723","Linleigh","F","11","6",17
"9761","Mckay","F","11","6",17
"9777","Miyuki","F","11","6",17
"9779","Mykala","F","11","6",17
"9799","Niley","F","11","6",17
"9807","Nyella","F","11","6",17
"9813","Oneida","F","11","6",17
"9821","Pallas","F","11","6",17
"9832","Raelinn","F","11","6",17
"9843","Rika","F","11","6",17
"9848","Roslin","F","11","6",17
"9865","Saranya","F","11","6",17
"9895","Symphany","F","11","6",17
"9898","Taimane","F","11","6",17
"9910","Terah","F","11","6",17
"9914","Tya","F","11","6",17
"9947","Yoseline","F","11","6",17
"9963","Aaryah","F","10","7",17
"9997","Aliena","F","10","7",17
"10008","Ameyaa","F","10","7",17
"10020","Angeleah","F","10","7",17
"10029","Anta","F","10","7",17
"10030","Argelia","F","10","7",17
"10037","Armina","F","10","7",17
"10046","Aubrionna","F","10","7",17
"10057","Bebe","F","10","7",17
"10075","Carra","F","10","7",17
"10078","Cereniti","F","10","7",17
"10081","Charish","F","10","7",17
"10082","Chelsee","F","10","7",17
"10089","Coralei","F","10","7",17
"10099","Daley","F","10","7",17
"10100","Dalida","F","10","7",17
"10102","Damyiah","F","10","7",17
"10116","Dhalia","F","10","7",17
"10121","Dublin","F","10","7",17
"10128","Elisabella","F","10","7",17
"10129","Elisandra","F","10","7",17
"10139","Emmajo","F","10","7",17
"10148","Evelyna","F","10","7",17
"10149","Faithful","F","10","7",17
"10157","Giani","F","10","7",17
"10180","Hetvi","F","10","7",17
"10192","Ivionna","F","10","7",17
"10201","Jakai","F","10","7",17
"10204","Jakia","F","10","7",17
"10244","Kalany","F","10","7",17
"10256","Kauri","F","10","7",17
"10261","Kaylina","F","10","7",17
"10269","Kemi","F","10","7",17
"10272","Kendrah","F","10","7",17
"10276","Ketsia","F","10","7",17
"10282","Kimoni","F","10","7",17
"10285","Kitty","F","10","7",17
"10304","Larson","F","10","7",17
"10306","Lavanya","F","10","7",17
"10313","Leyan","F","10","7",17
"10315","Liane","F","10","7",17
"10321","Lilyona","F","10","7",17
"10334","Luma","F","10","7",17
"10346","Magaby","F","10","7",17
"10351","Makalya","F","10","7",17
"10353","Malaia","F","10","7",17
"10355","Malarie","F","10","7",17
"10363","Marciana","F","10","7",17
"10375","Marykathryn","F","10","7",17
"10376","Maryum","F","10","7",17
"10380","Maye","F","10","7",17
"10402","Naiah","F","10","7",17
"10416","Niasia","F","10","7",17
"10433","Pailyn","F","10","7",17
"10436","Paylin","F","10","7",17
"10438","Penelopi","F","10","7",17
"10442","Peytin","F","10","7",17
"10445","Pranshi","F","10","7",17
"10449","Raffaella","F","10","7",17
"10501","Sherilyn","F","10","7",17
"10503","Shreshta","F","10","7",17
"10507","Sinead","F","10","7",17
"10510","Starlyn","F","10","7",17
"10519","Suzan","F","10","7",17
"10528","Tamra","F","10","7",17
"10541","Timberlyn","F","10","7",17
"10556","Vivyan","F","10","7",17
"10562","Yalexa","F","10","7",17
"10563","Yamile","F","10","7",17
"10569","Yittel","F","10","7",17
"10571","Yoali","F","10","7",17
"10604","Adalinn","F","9","8",17
"10641","Alilah","F","9","8",17
"10642","Alita","F","9","8",17
"10646","Allani","F","9","8",17
"10659","Amberlie","F","9","8",17
"10674","Andreyah","F","9","8",17
"10681","Anjolie","F","9","8",17
"10689","Anzleigh","F","9","8",17
"10693","Arelyn","F","9","8",17
"10705","Ary","F","9","8",17
"10708","Athenna","F","9","8",17
"10713","Avarey","F","9","8",17
"10718","Ayaan","F","9","8",17
"10727","Bellanie","F","9","8",17
"10737","Brae","F","9","8",17
"10740","Brendy","F","9","8",17
"10741","Brentlee","F","9","8",17
"10754","Brylea","F","9","8",17
"10756","Brylinn","F","9","8",17
"10759","Burkley","F","9","8",17
"10762","Calirose","F","9","8",17
"10770","Cartier","F","9","8",17
"10774","Cayenne","F","9","8",17
"10782","Chrissa","F","9","8",17
"10796","Dailany","F","9","8",17
"10810","Davinah","F","9","8",17
"10829","Dilyn","F","9","8",17
"10834","Dulcinea","F","9","8",17
"10838","Edwina","F","9","8",17
"10841","Elba","F","9","8",17
"10844","Elham","F","9","8",17
"10860","Emerlee","F","9","8",17
"10865","Emmilia","F","9","8",17
"10870","Espn","F","9","8",17
"10874","Evalene","F","9","8",17
"10900","Hamsini","F","9","8",17
"10906","Hatice","F","9","8",17
"10955","Jalah","F","9","8",17
"10974","Jelina","F","9","8",17
"10984","Jesalyn","F","9","8",17
"10996","Joelly","F","9","8",17
"11001","Journiee","F","9","8",17
"11007","Kaeley","F","9","8",17
"11011","Kalley","F","9","8",17
"11027","Kateryna","F","9","8",17
"11037","Keerat","F","9","8",17
"11047","Keyleigh","F","9","8",17
"11055","Kianah","F","9","8",17
"11059","Kiyla","F","9","8",17
"11068","Kynzee","F","9","8",17
"11070","Lachelle","F","9","8",17
"11072","Lailanie","F","9","8",17
"11085","Laurelei","F","9","8",17
"11090","Lennie","F","9","8",17
"11101","Lizzet","F","9","8",17
"11107","Loula","F","9","8",17
"11126","Makana","F","9","8",17
"11128","Makenli","F","9","8",17
"11141","Marieme","F","9","8",17
"11145","Marlina","F","9","8",17
"11148","Marvelous","F","9","8",17
"11159","Meriem","F","9","8",17
"11163","Mikelle","F","9","8",17
"11185","Navika","F","9","8",17
"11219","Raeven","F","9","8",17
"11222","Raivyn","F","9","8",17
"11227","Rarity","F","9","8",17
"11250","Royalle","F","9","8",17
"11252","Rubina","F","9","8",17
"11256","Sabryna","F","9","8",17
"11278","Sheza","F","9","8",17
"11289","Somer","F","9","8",17
"11296","Sreya","F","9","8",17
"11300","Suha","F","9","8",17
"11304","Sumire","F","9","8",17
"11316","Tamarah","F","9","8",17
"11317","Tatem","F","9","8",17
"11323","Teriyah","F","9","8",17
"11324","Tessah","F","9","8",17
"11331","Torin","F","9","8",17
"11336","Ula","F","9","8",17
"11338","Uriel","F","9","8",17
"11360","Yi","F","9","8",17
"11390","Aarini","F","8","9",17
"11407","Adrita","F","8","9",17
"11416","Airis","F","8","9",17
"11423","Aleda","F","8","9",17
"11428","Aliahna","F","8","9",17
"11435","Amabel","F","8","9",17
"11438","Ambellina","F","8","9",17
"11450","Anay","F","8","9",17
"11459","Annilee","F","8","9",17
"11460","Annya","F","8","9",17
"11472","Arline","F","8","9",17
"11475","Arraya","F","8","9",17
"11483","Ashlan","F","8","9",17
"11490","Atiya","F","8","9",17
"11501","Avian","F","8","9",17
"11503","Ayslin","F","8","9",17
"11505","Azarie","F","8","9",17
"11528","Briyelle","F","8","9",17
"11532","Cadee","F","8","9",17
"11544","Carver","F","8","9",17
"11557","Charlynn","F","8","9",17
"11612","Dillan","F","8","9",17
"11638","Elsbeth","F","8","9",17
"11644","Emelly","F","8","9",17
"11648","Emonii","F","8","9",17
"11649","Enyla","F","8","9",17
"11653","Eshani","F","8","9",17
"11685","Gracin","F","8","9",17
"11703","Helayna","F","8","9",17
"11707","Holy","F","8","9",17
"11710","Icelyn","F","8","9",17
"11735","Jaley","F","8","9",17
"11747","Jannelly","F","8","9",17
"11748","Jannette","F","8","9",17
"11754","Jaylianie","F","8","9",17
"11755","Jazline","F","8","9",17
"11759","Jenine","F","8","9",17
"11768","Jhoselyn","F","8","9",17
"11833","Khalina","F","8","9",17
"11834","Khara","F","8","9",17
"11837","Khyler","F","8","9",17
"11876","Lessly","F","8","9",17
"11877","Letha","F","8","9",17
"11885","Lilliah","F","8","9",17
"11927","Maloree","F","8","9",17
"11929","Maniah","F","8","9",17
"11938","Maribell","F","8","9",17
"11947","Marybelle","F","8","9",17
"11948","Maryfer","F","8","9",17
"11961","Mayley","F","8","9",17
"11962","Maylyn","F","8","9",17
"11965","Mckenize","F","8","9",17
"11971","Mery","F","8","9",17
"11997","Najae","F","8","9",17
"11999","Nalaysia","F","8","9",17
"12001","Nareh","F","8","9",17
"12006","Naw","F","8","9",17
"12012","Neidy","F","8","9",17
"12026","Noell","F","8","9",17
"12031","Nylan","F","8","9",17
"12053","Raidyn","F","8","9",17
"12057","Rakel","F","8","9",17
"12063","Realynn","F","8","9",17
"12067","Revel","F","8","9",17
"12084","Roselia","F","8","9",17
"12114","Serenidy","F","8","9",17
"12130","Sheyli","F","8","9",17
"12148","Staci","F","8","9",17
"12150","Stasia","F","8","9",17
"12168","Teeghan","F","8","9",17
"12169","Telia","F","8","9",17
"12178","Tiaraoluwa","F","8","9",17
"12198","Xiana","F","8","9",17
"12220","Zanai","F","8","9",17
"12257","Adea","F","7","10",17
"12259","Adileigh","F","7","10",17
"12280","Ailanie","F","7","10",17
"12281","Aimi","F","7","10",17
"12362","Ayliana","F","7","10",17
"12368","Azora","F","7","10",17
"12373","Baelynn","F","7","10",17
"12388","Braniyah","F","7","10",17
"12403","Brooklinn","F","7","10",17
"12421","Cassidi","F","7","10",17
"12433","Conleigh","F","7","10",17
"12441","Dailee","F","7","10",17
"12453","Delara","F","7","10",17
"12463","Deslynn","F","7","10",17
"12490","Ellawyn","F","7","10",17
"12515","Evalise","F","7","10",17
"12530","Fionnuala","F","7","10",17
"12562","Helina","F","7","10",17
"12624","Jazlynne","F","7","10",17
"12637","Jhoana","F","7","10",17
"12645","Joleah","F","7","10",17
"12659","Juni","F","7","10",17
"12690","Kayliegh","F","7","10",17
"12700","Keirsten","F","7","10",17
"12707","Kenlyn","F","7","10",17
"12731","Klair","F","7","10",17
"12762","Lavaya","F","7","10",17
"12786","Linna","F","7","10",17
"12804","Lucyanna","F","7","10",17
"12821","Makenah","F","7","10",17
"12904","Nathalya","F","7","10",17
"12927","Noela","F","7","10",17
"12932","Novali","F","7","10",17
"12941","Nyrie","F","7","10",17
"12945","Oluwatofunmi","F","7","10",17
"12955","Paidyn","F","7","10",17
"12962","Penelopy","F","7","10",17
"12964","Pessel","F","7","10",17
"12982","Ramata","F","7","10",17
"13016","Samai","F","7","10",17
"13018","Samarra","F","7","10",17
"13021","Sanii","F","7","10",17
"13046","Sharlette","F","7","10",17
"13049","Shiori","F","7","10",17
"13075","Suhavi","F","7","10",17
"13095","Tavi","F","7","10",17
"13129","Xiara","F","7","10",17
"13137","Yareliz","F","7","10",17
"13145","Yeraldin","F","7","10",17
"13154","Zafirah","F","7","10",17
"13161","Zanyia","F","7","10",17
"13166","Zionah","F","7","10",17
"13175","Aamna","F","6","11",17
"13190","Addyline","F","6","11",17
"13229","Aliaa","F","6","11",17
"13238","Alleah","F","6","11",17
"13276","Anelia","F","6","11",17
"13283","Anjani","F","6","11",17
"13304","Ariadnne","F","6","11",17
"13310","Aroura","F","6","11",17
"13331","Aydah","F","6","11",17
"13396","Chanley","F","6","11",17
"13413","Cyla","F","6","11",17
"13419","Dalyah","F","6","11",17
"13424","Danilyn","F","6","11",17
"13466","Ellasandra","F","6","11",17
"13486","Enedina","F","6","11",17
"13514","Fynn","F","6","11",17
"13527","Graylyn","F","6","11",17
"13538","Harshitha","F","6","11",17
"13562","Irha","F","6","11",17
"13571","Jack","F","6","11",17
"13582","Jamariah","F","6","11",17
"13607","Jiah","F","6","11",17
"13635","Kaliegh","F","6","11",17
"13654","Karrah","F","6","11",17
"13671","Keala","F","6","11",17
"13700","Kiele","F","6","11",17
"13713","Korri","F","6","11",17
"13722","Kymiah","F","6","11",17
"13741","Layann","F","6","11",17
"13749","Leeloo","F","6","11",17
"13753","Leyani","F","6","11",17
"13762","Lucilia","F","6","11",17
"13785","Maiara","F","6","11",17
"13832","Miamore","F","6","11",17
"13852","Moniece","F","6","11",17
"13857","Muskan","F","6","11",17
"13869","Namya","F","6","11",17
"13888","Nely","F","6","11",17
"13905","Nylani","F","6","11",17
"13909","Oluwademilade","F","6","11",17
"13939","Priyal","F","6","11",17
"13946","Raeleen","F","6","11",17
"13953","Ramyah","F","6","11",17
"13964","Rema","F","6","11",17
"13971","Roaa","F","6","11",17
"13975","Romie","F","6","11",17
"13993","Sadan","F","6","11",17
"14027","Shatha","F","6","11",17
"14029","Shayli","F","6","11",17
"14064","Sua","F","6","11",17
"14072","Synai","F","6","11",17
"14167","Zyria","F","6","11",17
"14183","Abisha","F","5","12",17
"14192","Adonai","F","5","12",17
"14204","Airah","F","5","12",17
"14227","Alla","F","5","12",17
"14230","Almas","F","5","12",17
"14234","Alyria","F","5","12",17
"14240","Amiri","F","5","12",17
"14265","Annaley","F","5","12",17
"14350","Betselot","F","5","12",17
"14403","Cira","F","5","12",17
"14428","Dalynn","F","5","12",17
"14466","Deya","F","5","12",17
"14479","Elinora","F","5","12",17
"14485","Elliahna","F","5","12",17
"14514","Ernestine","F","5","12",17
"14517","Evalette","F","5","12",17
"14683","Joelie","F","5","12",17
"14790","Layaan","F","5","12",17
"14796","Leara","F","5","12",17
"14988","Onesty","F","5","12",17
"14991","Paitlyn","F","5","12",17
"15038","Rion","F","5","12",17
"15105","Shanyla","F","5","12",17
"15122","Solimar","F","5","12",17
"15163","Traniyah","F","5","12",17
"15213","Yazhini","F","5","12",17
"15267","Zyleah","F","5","12",17
"9364","Aasia","F","11","5",16
"9378","Airalynn","F","11","5",16
"9385","Alannys","F","11","5",16
"9394","Aluel","F","11","5",16
"9410","Anfal","F","11","5",16
"9417","Arabela","F","11","5",16
"9438","Aynsley","F","11","5",16
"9464","Caitriona","F","11","5",16
"9470","Camdynn","F","11","5",16
"9482","Cerinity","F","11","5",16
"9497","Cyrene","F","11","5",16
"9546","Eri","F","11","5",16
"9550","Evalyna","F","11","5",16
"9564","Gift","F","11","5",16
"9569","Hadasah","F","11","5",16
"9609","Jaylenn","F","11","5",16
"9662","Keilee","F","11","5",16
"9726","Lorel","F","11","5",16
"9727","Lorelie","F","11","5",16
"9757","Maudie","F","11","5",16
"9759","Mayelin","F","11","5",16
"9784","Nai","F","11","5",16
"9802","Nivia","F","11","5",16
"9830","Psalm","F","11","5",16
"9863","Saphyre","F","11","5",16
"9879","Sheylin","F","11","5",16
"9907","Teasia","F","11","5",16
"9929","Whisper","F","11","5",16
"9934","Yaa","F","11","5",16
"9958","Zanaria","F","11","5",16
"9959","Zandria","F","11","5",16
"9966","Abel","F","10","6",16
"9970","Adamarie","F","10","6",16
"9975","Adellyn","F","10","6",16
"9978","Adiela","F","10","6",16
"10012","Anahlia","F","10","6",16
"10018","Anea","F","10","6",16
"10041","Ashiya","F","10","6",16
"10050","Avilynn","F","10","6",16
"10061","Beyonce","F","10","6",16
"10065","Bravery","F","10","6",16
"10067","Breyana","F","10","6",16
"10093","Dabney","F","10","6",16
"10106","Darielis","F","10","6",16
"10108","Darionna","F","10","6",16
"10110","Deangela","F","10","6",16
"10126","Elias","F","10","6",16
"10144","Esbeidy","F","10","6",16
"10145","Evamaria","F","10","6",16
"10173","Hawwa","F","10","6",16
"10217","Jaysie","F","10","6",16
"10223","Jettie","F","10","6",16
"10231","Jozey","F","10","6",16
"10232","Juel","F","10","6",16
"10238","Kadience","F","10","6",16
"10242","Kailynne","F","10","6",16
"10245","Kaleeyah","F","10","6",16
"10250","Kannon","F","10","6",16
"10266","Keili","F","10","6",16
"10286","Kiyani","F","10","6",16
"10289","Kona","F","10","6",16
"10300","Lalia","F","10","6",16
"10310","Leighlani","F","10","6",16
"10332","Lubna","F","10","6",16
"10357","Maleaha","F","10","6",16
"10359","Malikah","F","10","6",16
"10366","Maripaz","F","10","6",16
"10367","Mariza","F","10","6",16
"10372","Marshae","F","10","6",16
"10387","Mi","F","10","6",16
"10390","Mikka","F","10","6",16
"10407","Natalye","F","10","6",16
"10411","Navina","F","10","6",16
"10413","Nel","F","10","6",16
"10428","Nyia","F","10","6",16
"10432","Oyindamola","F","10","6",16
"10434","Parneet","F","10","6",16
"10441","Peytan","F","10","6",16
"10453","Randa","F","10","6",16
"10455","Raveena","F","10","6",16
"10463","Rehana","F","10","6",16
"10470","Rital","F","10","6",16
"10482","Ryilee","F","10","6",16
"10487","Safiyya","F","10","6",16
"10489","Salsabil","F","10","6",16
"10513","Suad","F","10","6",16
"10515","Sula","F","10","6",16
"10537","Tesslyn","F","10","6",16
"10540","Tiani","F","10","6",16
"10548","Tylasia","F","10","6",16
"10570","Yizel","F","10","6",16
"10577","Zandaya","F","10","6",16
"10578","Zandra","F","10","6",16
"10596","Aalaya","F","9","7",16
"10598","Aaleigha","F","9","7",16
"10601","Aariona","F","9","7",16
"10603","Abryana","F","9","7",16
"10612","Advaita","F","9","7",16
"10614","Afsa","F","9","7",16
"10617","Ahlina","F","9","7",16
"10621","Ahniya","F","9","7",16
"10623","Aidee","F","9","7",16
"10626","Aija","F","9","7",16
"10627","Aika","F","9","7",16
"10634","Alaysiah","F","9","7",16
"10635","Alberta","F","9","7",16
"10644","Alixandra","F","9","7",16
"10648","Alyannah","F","9","7",16
"10667","Amirykal","F","9","7",16
"10671","Analysia","F","9","7",16
"10679","Aniyha","F","9","7",16
"10685","Annastacia","F","9","7",16
"10688","Annisten","F","9","7",16
"10690","Apphia","F","9","7",16
"10698","Aritza","F","9","7",16
"10699","Arla","F","9","7",16
"10700","Arly","F","9","7",16
"10709","Audryna","F","9","7",16
"10711","Avanni","F","9","7",16
"10719","Ayzlee","F","9","7",16
"10722","Azaylee","F","9","7",16
"10728","Beren","F","9","7",16
"10732","Bettie","F","9","7",16
"10733","Biak","F","9","7",16
"10747","Brindley","F","9","7",16
"10749","Britt","F","9","7",16
"10753","Bryella","F","9","7",16
"10758","Bryson","F","9","7",16
"10761","Caasi","F","9","7",16
"10766","Cammi","F","9","7",16
"10767","Camree","F","9","7",16
"10773","Cataleah","F","9","7",16
"10783","Christalyn","F","9","7",16
"10788","Corine","F","9","7",16
"10827","Diara","F","9","7",16
"10828","Diego","F","9","7",16
"10833","Disney","F","9","7",16
"10842","Elene","F","9","7",16
"10861","Emila","F","9","7",16
"10872","Eunique","F","9","7",16
"10878","Evian","F","9","7",16
"10880","Fahima","F","9","7",16
"10882","Fatmata","F","9","7",16
"10911","Hazlee","F","9","7",16
"10916","Helem","F","9","7",16
"10917","Hemi","F","9","7",16
"10919","Henli","F","9","7",16
"10921","Henriette","F","9","7",16
"10928","Iliany","F","9","7",16
"10929","Ilina","F","9","7",16
"10934","Isabellagrace","F","9","7",16
"10951","Jahleah","F","9","7",16
"10954","Jaira","F","9","7",16
"10960","Jameya","F","9","7",16
"10964","Janisha","F","9","7",16
"10965","Japleen","F","9","7",16
"10969","Javayah","F","9","7",16
"10973","Jazzlin","F","9","7",16
"10994","Joclyn","F","9","7",16
"11008","Kahleah","F","9","7",16
"11012","Kalyse","F","9","7",16
"11016","Karelly","F","9","7",16
"11032","Kaylise","F","9","7",16
"11035","Kaziyah","F","9","7",16
"11036","Keelan","F","9","7",16
"11043","Kennidee","F","9","7",16
"11044","Keoni","F","9","7",16
"11056","Kimmie","F","9","7",16
"11063","Kristyana","F","9","7",16
"11082","Laryiah","F","9","7",16
"11106","Loukya","F","9","7",16
"11111","Lylliana","F","9","7",16
"11116","Madelene","F","9","7",16
"11127","Makeila","F","9","7",16
"11130","Makylie","F","9","7",16
"11138","Mane","F","9","7",16
"11146","Marshay","F","9","7",16
"11154","Melaysia","F","9","7",16
"11161","Meylani","F","9","7",16
"11168","Millena","F","9","7",16
"11173","Monalisa","F","9","7",16
"11174","Mone","F","9","7",16
"11180","Nakita","F","9","7",16
"11186","Nazaret","F","9","7",16
"11190","Nelli","F","9","7",16
"11191","Neveyah","F","9","7",16
"11210","Paisli","F","9","7",16
"11211","Pemberley","F","9","7",16
"11226","Raphaelle","F","9","7",16
"11232","Reynolds","F","9","7",16
"11234","Rhia","F","9","7",16
"11240","Riki","F","9","7",16
"11277","Sheri","F","9","7",16
"11281","Sieanna","F","9","7",16
"11298","Success","F","9","7",16
"11301","Suhailah","F","9","7",16
"11303","Sumaiyah","F","9","7",16
"11349","Willemina","F","9","7",16
"11354","Xola","F","9","7",16
"11363","Yitzel","F","9","7",16
"11364","Yona","F","9","7",16
"11366","Yuxi","F","9","7",16
"11400","Addysyn","F","8","8",16
"11414","Ahnyla","F","8","8",16
"11421","Alanoud","F","8","8",16
"11434","Alyda","F","8","8",16
"11437","Amaura","F","8","8",16
"11449","Ananiah","F","8","8",16
"11457","Annelisa","F","8","8",16
"11471","Arlenne","F","8","8",16
"11506","Azizah","F","8","8",16
"11512","Bethsaida","F","8","8",16
"11521","Breyanna","F","8","8",16
"11522","Brieana","F","8","8",16
"11523","Briele","F","8","8",16
"11549","Cataleia","F","8","8",16
"11553","Chaniyah","F","8","8",16
"11556","Charlyn","F","8","8",16
"11580","Cyrine","F","8","8",16
"11582","Dakari","F","8","8",16
"11592","Dariel","F","8","8",16
"11593","Darrielle","F","8","8",16
"11604","Dellah","F","8","8",16
"11631","Ellamay","F","8","8",16
"11641","Emanuella","F","8","8",16
"11645","Emilyann","F","8","8",16
"11655","Esthela","F","8","8",16
"11663","Fara","F","8","8",16
"11672","Gavyn","F","8","8",16
"11696","Harbour","F","8","8",16
"11716","Inanna","F","8","8",16
"11738","Jamara","F","8","8",16
"11746","Janila","F","8","8",16
"11750","Jaxi","F","8","8",16
"11762","Jennesis","F","8","8",16
"11772","Jiovanna","F","8","8",16
"11776","Joelene","F","8","8",16
"11800","Kalla","F","8","8",16
"11805","Kamrin","F","8","8",16
"11808","Kanisha","F","8","8",16
"11811","Karalina","F","8","8",16
"11816","Kassady","F","8","8",16
"11832","Khaila","F","8","8",16
"11848","Kristan","F","8","8",16
"11849","Kristelle","F","8","8",16
"11854","Kynslei","F","8","8",16
"11871","Leilanee","F","8","8",16
"11882","Liela","F","8","8",16
"11884","Lilit","F","8","8",16
"11897","Lupe","F","8","8",16
"11898","Lura","F","8","8",16
"11901","Lylla","F","8","8",16
"11912","Maggi","F","8","8",16
"11914","Maiana","F","8","8",16
"11915","Makaiah","F","8","8",16
"11920","Makinna","F","8","8",16
"11930","Manna","F","8","8",16
"11953","Massa","F","8","8",16
"11968","Memorie","F","8","8",16
"11982","Mirha","F","8","8",16
"11991","Mykelti","F","8","8",16
"12002","Narissa","F","8","8",16
"12003","Nasiya","F","8","8",16
"12009","Nazyia","F","8","8",16
"12019","Nialah","F","8","8",16
"12033","Oaklei","F","8","8",16
"12040","Phaith","F","8","8",16
"12047","Quynh","F","8","8",16
"12064","Rein","F","8","8",16
"12074","Ricky","F","8","8",16
"12081","Rorey","F","8","8",16
"12092","Rye","F","8","8",16
"12096","Sahaana","F","8","8",16
"12102","Samyuktha","F","8","8",16
"12110","Sayana","F","8","8",16
"12125","Shayden","F","8","8",16
"12133","Sibel","F","8","8",16
"12134","Sibley","F","8","8",16
"12139","Skyllar","F","8","8",16
"12153","Summerlyn","F","8","8",16
"12164","Talley","F","8","8",16
"12165","Tami","F","8","8",16
"12188","Vallery","F","8","8",16
"12192","Venezia","F","8","8",16
"12199","Xianna","F","8","8",16
"12205","Yancy","F","8","8",16
"12210","Yuktha","F","8","8",16
"12212","Zaeleigh","F","8","8",16
"12216","Zakya","F","8","8",16
"12222","Zarie","F","8","8",16
"12230","Zniyah","F","8","8",16
"12233","Zoejane","F","8","8",16
"12245","Aashka","F","7","9",16
"12248","Aayra","F","7","9",16
"12265","Aevah","F","7","9",16
"12279","Aidy","F","7","9",16
"12282","Ainzley","F","7","9",16
"12285","Aissa","F","7","9",16
"12286","Aiyonna","F","7","9",16
"12300","Amberlin","F","7","9",16
"12328","Aoki","F","7","9",16
"12335","Arieliz","F","7","9",16
"12336","Arijana","F","7","9",16
"12347","Audianna","F","7","9",16
"12353","Avabelle","F","7","9",16
"12378","Bhavika","F","7","9",16
"12385","Blyss","F","7","9",16
"12395","Brigitta","F","7","9",16
"12400","Brityn","F","7","9",16
"12402","Bronwen","F","7","9",16
"12404","Brya","F","7","9",16
"12407","Brynnlie","F","7","9",16
"12417","Carleah","F","7","9",16
"12434","Copelynn","F","7","9",16
"12464","Destani","F","7","9",16
"12465","Deva","F","7","9",16
"12471","Drishya","F","7","9",16
"12475","Eboni","F","7","9",16
"12488","Eline","F","7","9",16
"12495","Elliora","F","7","9",16
"12499","Emileah","F","7","9",16
"12501","Emmaree","F","7","9",16
"12503","Emyah","F","7","9",16
"12507","Enora","F","7","9",16
"12513","Eudora","F","7","9",16
"12517","Evania","F","7","9",16
"12520","Eyana","F","7","9",16
"12526","Fariza","F","7","9",16
"12560","Harris","F","7","9",16
"12582","Israella","F","7","9",16
"12584","Ivianna","F","7","9",16
"12587","Jaemarie","F","7","9",16
"12597","Jakyia","F","7","9",16
"12611","Janeliz","F","7","9",16
"12612","Jannie","F","7","9",16
"12614","Jaonna","F","7","9",16
"12629","Jennessy","F","7","9",16
"12654","Juliannah","F","7","9",16
"12661","Kacelynn","F","7","9",16
"12668","Kaliann","F","7","9",16
"12706","Kendry","F","7","9",16
"12708","Kenniyah","F","7","9",16
"12710","Kesha","F","7","9",16
"12714","Khaya","F","7","9",16
"12724","Kimiyah","F","7","9",16
"12739","Krissa","F","7","9",16
"12748","Kysa","F","7","9",16
"12753","Lanessa","F","7","9",16
"12770","Lenise","F","7","9",16
"12810","Maddielynn","F","7","9",16
"12818","Mahlet","F","7","9",16
"12820","Makayah","F","7","9",16
"12829","Malley","F","7","9",16
"12838","Maryjayne","F","7","9",16
"12848","Mazzie","F","7","9",16
"12858","Meriah","F","7","9",16
"12860","Merissa","F","7","9",16
"12875","Mireyah","F","7","9",16
"12884","Morireoluwa","F","7","9",16
"12889","Myrikal","F","7","9",16
"12894","Najat","F","7","9",16
"12905","Naturi","F","7","9",16
"12915","Ngun","F","7","9",16
"12929","Noelly","F","7","9",16
"12935","Nyela","F","7","9",16
"12968","Prarthana","F","7","9",16
"13003","Rozelyn","F","7","9",16
"13004","Rudi","F","7","9",16
"13012","Saidy","F","7","9",16
"13020","Samus","F","7","9",16
"13030","Satcha","F","7","9",16
"13033","Saylem","F","7","9",16
"13035","Seela","F","7","9",16
"13044","Shanvika","F","7","9",16
"13050","Shirel","F","7","9",16
"13058","Siniyah","F","7","9",16
"13071","Sorcha","F","7","9",16
"13082","Sylver","F","7","9",16
"13087","Talullah","F","7","9",16
"13100","Thara","F","7","9",16
"13110","Tyann","F","7","9",16
"13114","Vanelope","F","7","9",16
"13134","Yailyn","F","7","9",16
"13195","Adesuwa","F","6","10",16
"13196","Adiella","F","6","10",16
"13204","Adriann","F","6","10",16
"13209","Ahmaya","F","6","10",16
"13212","Akhila","F","6","10",16
"13231","Alie","F","6","10",16
"13246","Alysen","F","6","10",16
"13252","Amanat","F","6","10",16
"13292","Anni","F","6","10",16
"13334","Aylla","F","6","10",16
"13350","Bradie","F","6","10",16
"13362","Bristyn","F","6","10",16
"13367","Bryndal","F","6","10",16
"13401","Chiziterem","F","6","10",16
"13414","Cymone","F","6","10",16
"13427","Dari","F","6","10",16
"13431","Dayah","F","6","10",16
"13487","Enza","F","6","10",16
"13491","Ernestina","F","6","10",16
"13541","Havisha","F","6","10",16
"13547","Hidayah","F","6","10",16
"13548","Hildegard","F","6","10",16
"13552","Huntlee","F","6","10",16
"13569","Jaalah","F","6","10",16
"13616","Josefa","F","6","10",16
"13620","Jurnei","F","6","10",16
"13670","Kazlyn","F","6","10",16
"13673","Keari","F","6","10",16
"13696","Khamryn","F","6","10",16
"13703","Kimimila","F","6","10",16
"13714","Kourtnee","F","6","10",16
"13770","Lyfe","F","6","10",16
"13807","Marlea","F","6","10",16
"13813","Maxx","F","6","10",16
"13838","Milarose","F","6","10",16
"13859","Mylin","F","6","10",16
"13864","Nallah","F","6","10",16
"13868","Namira","F","6","10",16
"13916","Oyinkansola","F","6","10",16
"13928","Penellope","F","6","10",16
"13935","Price","F","6","10",16
"13952","Ramsie","F","6","10",16
"13958","Rayley","F","6","10",16
"14022","Serana","F","6","10",16
"14023","Shaelee","F","6","10",16
"14033","Shresta","F","6","10",16
"14045","Skii","F","6","10",16
"14059","Starlette","F","6","10",16
"14100","Vara","F","6","10",16
"14131","Yukari","F","6","10",16
"14140","Zaneta","F","6","10",16
"14161","Zuleima","F","6","10",16
"14162","Zyaira","F","6","10",16
"14168","Aabriella","F","5","11",16
"14202","Aidelyn","F","5","11",16
"14260","Andreea","F","5","11",16
"14271","Annetta","F","5","11",16
"14279","Arah","F","5","11",16
"14356","Blessen","F","5","11",16
"14401","Chrysanthemum","F","5","11",16
"14539","Federica","F","5","11",16
"14565","Gurseerat","F","5","11",16
"14603","Imane","F","5","11",16
"14623","Jaelyne","F","5","11",16
"14625","Jahnyla","F","5","11",16
"14636","Jamariyah","F","5","11",16
"14650","Jaycelynn","F","5","11",16
"14677","Jihan","F","5","11",16
"14814","Lilliannah","F","5","11",16
"14859","Malaysiah","F","5","11",16
"14863","Malyiah","F","5","11",16
"14867","Maranatha","F","5","11",16
"14878","Marlys","F","5","11",16
"14908","Mikhaila","F","5","11",16
"14934","Naloni","F","5","11",16
"14938","Naria","F","5","11",16
"15054","Rowe","F","5","11",16
"15055","Rozalee","F","5","11",16
"15061","Rutila","F","5","11",16
"15093","Seniyah","F","5","11",16
"15103","Shamara","F","5","11",16
"15104","Shambhavi","F","5","11",16
"15117","Skyah","F","5","11",16
"15157","Thy","F","5","11",16
"15172","Uri","F","5","11",16
"15177","Veena","F","5","11",16
"15214","Yazmeen","F","5","11",16
"15240","Zayleen","F","5","11",16
"15241","Zaylei","F","5","11",16
"9967","Achol","F","10","5",15
"9971","Adannaya","F","10","5",15
"9981","Aeriella","F","10","5",15
"9982","Aero","F","10","5",15
"9984","Ahmirah","F","10","5",15
"9987","Aizlee","F","10","5",15
"9989","Alaiyna","F","10","5",15
"10003","Amarise","F","10","5",15
"10010","Amiyla","F","10","5",15
"10011","Amiyrah","F","10","5",15
"10019","Aneth","F","10","5",15
"10034","Arihana","F","10","5",15
"10035","Arleny","F","10","5",15
"10043","Asiana","F","10","5",15
"10056","Baylen","F","10","5",15
"10079","Cerise","F","10","5",15
"10086","Cire","F","10","5",15
"10104","Danie","F","10","5",15
"10118","Diamante","F","10","5",15
"10130","Elizbeth","F","10","5",15
"10131","Elky","F","10","5",15
"10146","Evangaline","F","10","5",15
"10154","Francia","F","10","5",15
"10156","Geniyah","F","10","5",15
"10161","Gracilyn","F","10","5",15
"10168","Haidy","F","10","5",15
"10184","Hyla","F","10","5",15
"10193","Iyani","F","10","5",15
"10198","Jahira","F","10","5",15
"10203","Jakelyn","F","10","5",15
"10207","Jamese","F","10","5",15
"10214","Jaylea","F","10","5",15
"10233","Juleah","F","10","5",15
"10236","Julionna","F","10","5",15
"10251","Karelyn","F","10","5",15
"10263","Kaytie","F","10","5",15
"10268","Kelina","F","10","5",15
"10279","Khamille","F","10","5",15
"10288","Klohe","F","10","5",15
"10307","Laylonie","F","10","5",15
"10349","Makaelyn","F","10","5",15
"10361","Malonie","F","10","5",15
"10395","Mishell","F","10","5",15
"10397","Myesha","F","10","5",15
"10400","Nadalie","F","10","5",15
"10420","Niralya","F","10","5",15
"10430","Oliviyah","F","10","5",15
"10458","Rayelynn","F","10","5",15
"10460","Raylynne","F","10","5",15
"10462","Reesa","F","10","5",15
"10473","Rogan","F","10","5",15
"10492","Savreen","F","10","5",15
"10499","Shayra","F","10","5",15
"10500","Shellby","F","10","5",15
"10527","Tamani","F","10","5",15
"10542","Timya","F","10","5",15
"10546","Twisha","F","10","5",15
"10547","Tyjae","F","10","5",15
"10553","Venelope","F","10","5",15
"10599","Aalina","F","9","6",15
"10609","Adriannah","F","9","6",15
"10625","Aiesha","F","9","6",15
"10650","Alysandra","F","9","6",15
"10658","Amatullah","F","9","6",15
"10682","Anmarie","F","9","6",15
"10697","Arion","F","9","6",15
"10707","Ashten","F","9","6",15
"10715","Avion","F","9","6",15
"10726","Bawi","F","9","6",15
"10730","Besan","F","9","6",15
"10746","Brindle","F","9","6",15
"10748","Briony","F","9","6",15
"10760","Byrdie","F","9","6",15
"10763","Camarie","F","9","6",15
"10780","Chinyere","F","9","6",15
"10781","Chosen","F","9","6",15
"10789","Courtnee","F","9","6",15
"10790","Crosley","F","9","6",15
"10792","Cyanne","F","9","6",15
"10800","Damira","F","9","6",15
"10807","Danyka","F","9","6",15
"10808","Darlynn","F","9","6",15
"10814","Dekayla","F","9","6",15
"10822","Deylani","F","9","6",15
"10823","Deziah","F","9","6",15
"10831","Dimitra","F","9","6",15
"10837","Edom","F","9","6",15
"10855","Elorah","F","9","6",15
"10858","Emanuelly","F","9","6",15
"10862","Emmalena","F","9","6",15
"10887","Genisys","F","9","6",15
"10890","Gizel","F","9","6",15
"10893","Griffyn","F","9","6",15
"10897","Haifa","F","9","6",15
"10898","Hallelujah","F","9","6",15
"10899","Hally","F","9","6",15
"10910","Haylo","F","9","6",15
"10923","Hollee","F","9","6",15
"10925","Hyacinth","F","9","6",15
"10938","Isaly","F","9","6",15
"10939","Isatou","F","9","6",15
"10941","Iselle","F","9","6",15
"10943","Itati","F","9","6",15
"10966","Jarielys","F","9","6",15
"10968","Javaya","F","9","6",15
"10970","Jaxx","F","9","6",15
"10972","Jayliani","F","9","6",15
"10975","Jeliyah","F","9","6",15
"10977","Jenevie","F","9","6",15
"10986","Jewelia","F","9","6",15
"10989","Jhenesis","F","9","6",15
"10999","Jordann","F","9","6",15
"11004","Juliauna","F","9","6",15
"11014","Kanaya","F","9","6",15
"11015","Kani","F","9","6",15
"11020","Karolyna","F","9","6",15
"11024","Kassadi","F","9","6",15
"11025","Kassey","F","9","6",15
"11034","Kaylon","F","9","6",15
"11040","Kemaya","F","9","6",15
"11042","Kenidi","F","9","6",15
"11050","Khailey","F","9","6",15
"11051","Khalee","F","9","6",15
"11052","Khayla","F","9","6",15
"11054","Kiahna","F","9","6",15
"11061","Kmya","F","9","6",15
"11074","Lainy","F","9","6",15
"11093","Lexxi","F","9","6",15
"11104","Loreley","F","9","6",15
"11123","Maize","F","9","6",15
"11124","Maka","F","9","6",15
"11137","Mandie","F","9","6",15
"11139","Marabella","F","9","6",15
"11150","Matylda","F","9","6",15
"11156","Meleena","F","9","6",15
"11162","Miaisabella","F","9","6",15
"11164","Mikylah","F","9","6",15
"11166","Milcah","F","9","6",15
"11170","Mirola","F","9","6",15
"11189","Neera","F","9","6",15
"11199","Norelle","F","9","6",15
"11209","Ornella","F","9","6",15
"11212","Penley","F","9","6",15
"11218","Raelie","F","9","6",15
"11224","Raliyah","F","9","6",15
"11259","Sahory","F","9","6",15
"11263","Samadhi","F","9","6",15
"11264","Samariah","F","9","6",15
"11275","Shamyra","F","9","6",15
"11276","Sharlyn","F","9","6",15
"11283","Simara","F","9","6",15
"11286","Skyylar","F","9","6",15
"11294","Southern","F","9","6",15
"11295","Sreeja","F","9","6",15
"11297","Srihitha","F","9","6",15
"11308","Sway","F","9","6",15
"11312","Taija","F","9","6",15
"11359","Yeslin","F","9","6",15
"11376","Zendeya","F","9","6",15
"11379","Zitlaly","F","9","6",15
"11383","Zyia","F","9","6",15
"11395","Adaliyah","F","8","7",15
"11399","Addlynn","F","8","7",15
"11404","Adiana","F","8","7",15
"11408","Advita","F","8","7",15
"11412","Ahavah","F","8","7",15
"11422","Alayssa","F","8","7",15
"11430","Aliona","F","8","7",15
"11432","Aliyannah","F","8","7",15
"11442","Amita","F","8","7",15
"11452","Andrina","F","8","7",15
"11453","Anelis","F","8","7",15
"11458","Annelle","F","8","7",15
"11470","Ariele","F","8","7",15
"11488","Athanasia","F","8","7",15
"11509","Baneen","F","8","7",15
"11514","Billi","F","8","7",15
"11517","Breea","F","8","7",15
"11518","Breella","F","8","7",15
"11520","Brenya","F","8","7",15
"11525","Brinlyn","F","8","7",15
"11530","Brycelyn","F","8","7",15
"11535","Calena","F","8","7",15
"11536","Calianne","F","8","7",15
"11537","Caliegh","F","8","7",15
"11548","Cassiopeia","F","8","7",15
"11550","Caycee","F","8","7",15
"11551","Cecylia","F","8","7",15
"11563","Christionna","F","8","7",15
"11564","Christyana","F","8","7",15
"11567","Cidney","F","8","7",15
"11571","Claudine","F","8","7",15
"11575","Corri","F","8","7",15
"11578","Cristine","F","8","7",15
"11591","Danyiah","F","8","7",15
"11594","Daryah","F","8","7",15
"11596","Daveigh","F","8","7",15
"11598","Deari","F","8","7",15
"11599","Dejanae","F","8","7",15
"11603","Delisa","F","8","7",15
"11618","Dulcie","F","8","7",15
"11620","Edan","F","8","7",15
"11627","Eleanna","F","8","7",15
"11633","Elliah","F","8","7",15
"11635","Ellyette","F","8","7",15
"11640","Elycia","F","8","7",15
"11660","Evva","F","8","7",15
"11661","Eyva","F","8","7",15
"11662","Fabianna","F","8","7",15
"11668","Frimy","F","8","7",15
"11670","Gabriellah","F","8","7",15
"11673","Geena","F","8","7",15
"11676","Genova","F","8","7",15
"11677","Gentri","F","8","7",15
"11681","Giuseppina","F","8","7",15
"11683","Graceland","F","8","7",15
"11713","Ileah","F","8","7",15
"11722","Iyah","F","8","7",15
"11725","Jaeli","F","8","7",15
"11726","Jaiah","F","8","7",15
"11737","Jalyric","F","8","7",15
"11742","Janelli","F","8","7",15
"11765","Jersee","F","8","7",15
"11771","Jinger","F","8","7",15
"11779","Johnni","F","8","7",15
"11782","Jouri","F","8","7",15
"11790","Kahmya","F","8","7",15
"11801","Kallyn","F","8","7",15
"11806","Kamyrn","F","8","7",15
"11812","Karilyn","F","8","7",15
"11818","Katrin","F","8","7",15
"11825","Keiara","F","8","7",15
"11829","Kenndra","F","8","7",15
"11831","Ketzia","F","8","7",15
"11836","Khilynn","F","8","7",15
"11846","Kortni","F","8","7",15
"11857","Laiklynn","F","8","7",15
"11861","Lamaria","F","8","7",15
"11863","Lashawna","F","8","7",15
"11865","Lavada","F","8","7",15
"11868","Laylianna","F","8","7",15
"11878","Levina","F","8","7",15
"11883","Lilienne","F","8","7",15
"11886","Lillieanna","F","8","7",15
"11889","Liona","F","8","7",15
"11891","Lorissa","F","8","7",15
"11892","Lorynn","F","8","7",15
"11905","Macelyn","F","8","7",15
"11911","Magdalynn","F","8","7",15
"11939","Marielis","F","8","7",15
"11941","Mariona","F","8","7",15
"11955","Matalyn","F","8","7",15
"11986","Moon","F","8","7",15
"11990","Myalynn","F","8","7",15
"11994","Naara","F","8","7",15
"11996","Nadra","F","8","7",15
"12020","Nianna","F","8","7",15
"12052","Raheel","F","8","7",15
"12069","Rhaya","F","8","7",15
"12071","Rianshi","F","8","7",15
"12072","Richa","F","8","7",15
"12079","Rokaya","F","8","7",15
"12087","Rubani","F","8","7",15
"12089","Rumer","F","8","7",15
"12091","Ryatt","F","8","7",15
"12118","Shakiya","F","8","7",15
"12119","Shanae","F","8","7",15
"12120","Shanyia","F","8","7",15
"12132","Shy","F","8","7",15
"12135","Sidnee","F","8","7",15
"12140","Snigdha","F","8","7",15
"12146","Sreenika","F","8","7",15
"12174","Terrianna","F","8","7",15
"12175","Terriona","F","8","7",15
"12179","Tiera","F","8","7",15
"12211","Yzabelle","F","8","7",15
"12219","Zaley","F","8","7",15
"12224","Zayneb","F","8","7",15
"12225","Zeidy","F","8","7",15
"12228","Zihan","F","8","7",15
"12235","Zoriana","F","8","7",15
"12237","Zyairah","F","8","7",15
"12247","Aavah","F","7","8",15
"12253","Adaleyza","F","7","8",15
"12256","Addlyn","F","7","8",15
"12262","Adriene","F","7","8",15
"12270","Ahleah","F","7","8",15
"12272","Ahmyah","F","7","8",15
"12274","Ahni","F","7","8",15
"12299","Amauria","F","7","8",15
"12316","Aneliese","F","7","8",15
"12317","Anesa","F","7","8",15
"12322","Annalis","F","7","8",15
"12333","Arelly","F","7","8",15
"12337","Aroush","F","7","8",15
"12340","Asaiah","F","7","8",15
"12344","Athyna","F","7","8",15
"12363","Aymar","F","7","8",15
"12369","Azori","F","7","8",15
"12376","Bentlie","F","7","8",15
"12379","Bitania","F","7","8",15
"12381","Blaiklee","F","7","8",15
"12401","Brixtyn","F","7","8",15
"12408","Brynnly","F","7","8",15
"12431","Chriselle","F","7","8",15
"12439","Daianna","F","7","8",15
"12444","Daraly","F","7","8",15
"12466","Deyana","F","7","8",15
"12468","Domino","F","7","8",15
"12473","Dylilah","F","7","8",15
"12482","Elaiza","F","7","8",15
"12492","Ellenie","F","7","8",15
"12500","Emmaleah","F","7","8",15
"12509","Ephrata","F","7","8",15
"12510","Eriyana","F","7","8",15
"12532","Fynnley","F","7","8",15
"12536","Gael","F","7","8",15
"12556","Halah","F","7","8",15
"12576","Insiya","F","7","8",15
"12590","Jahmiya","F","7","8",15
"12593","Jaislyn","F","7","8",15
"12609","Janaria","F","7","8",15
"12616","Jareli","F","7","8",15
"12619","Jasline","F","7","8",15
"12620","Javonna","F","7","8",15
"12621","Jaydelin","F","7","8",15
"12627","Jeniffer","F","7","8",15
"12641","Jodee","F","7","8",15
"12650","Jossie","F","7","8",15
"12657","Juliza","F","7","8",15
"12664","Kaeya","F","7","8",15
"12673","Kamilya","F","7","8",15
"12678","Karthika","F","7","8",15
"12679","Kartier","F","7","8",15
"12687","Kaveri","F","7","8",15
"12692","Kayna","F","7","8",15
"12718","Khylah","F","7","8",15
"12723","Kimbree","F","7","8",15
"12737","Korrah","F","7","8",15
"12743","Kymia","F","7","8",15
"12745","Kynzli","F","7","8",15
"12746","Kyrianna","F","7","8",15
"12754","Laniece","F","7","8",15
"12756","Lanyia","F","7","8",15
"12759","Larue","F","7","8",15
"12769","Lenae","F","7","8",15
"12785","Linlee","F","7","8",15
"12793","Lochlan","F","7","8",15
"12800","Lucelia","F","7","8",15
"12801","Lucillia","F","7","8",15
"12812","Maebh","F","7","8",15
"12835","Marijane","F","7","8",15
"12837","Marybella","F","7","8",15
"12840","Masiah","F","7","8",15
"12850","Mckenzye","F","7","8",15
"12853","Mekenna","F","7","8",15
"12878","Miwa","F","7","8",15
"12882","Montserrath","F","7","8",15
"12893","Naida","F","7","8",15
"12906","Naveena","F","7","8",15
"12913","Neisha","F","7","8",15
"12919","Nikoleta","F","7","8",15
"12921","Nili","F","7","8",15
"12925","Niyana","F","7","8",15
"12934","Nyara","F","7","8",15
"12939","Nyliyah","F","7","8",15
"12944","Oluchi","F","7","8",15
"12947","Omnia","F","7","8",15
"12970","Preslynn","F","7","8",15
"12971","Pryncess","F","7","8",15
"12973","Quinnlee","F","7","8",15
"12978","Rainna","F","7","8",15
"12983","Ramie","F","7","8",15
"12988","Relena","F","7","8",15
"13009","Ryleeann","F","7","8",15
"13011","Sahalie","F","7","8",15
"13015","Salia","F","7","8",15
"13042","Shaleigh","F","7","8",15
"13043","Shamsa","F","7","8",15
"13052","Shreeja","F","7","8",15
"13065","Skylette","F","7","8",15
"13066","Smera","F","7","8",15
"13068","Sondos","F","7","8",15
"13074","Stone","F","7","8",15
"13088","Tamzin","F","7","8",15
"13093","Tasfia","F","7","8",15
"13101","Theory","F","7","8",15
"13102","Tilley","F","7","8",15
"13116","Vannia","F","7","8",15
"13117","Vasti","F","7","8",15
"13131","Yaeli","F","7","8",15
"13140","Yatzary","F","7","8",15
"13141","Yaxeni","F","7","8",15
"13147","Yixin","F","7","8",15
"13155","Zahirah","F","7","8",15
"13156","Zaileigh","F","7","8",15
"13159","Zamorah","F","7","8",15
"13160","Zani","F","7","8",15
"13172","Aala","F","6","9",15
"13177","Aayana","F","6","9",15
"13181","Abiah","F","6","9",15
"13185","Adalea","F","6","9",15
"13191","Addylyn","F","6","9",15
"13194","Adelinne","F","6","9",15
"13217","Alazay","F","6","9",15
"13271","Anarosa","F","6","9",15
"13272","Anastazja","F","6","9",15
"13279","Angele","F","6","9",15
"13286","Annalei","F","6","9",15
"13297","Anysia","F","6","9",15
"13298","Anzley","F","6","9",15
"13320","Aury","F","6","9",15
"13330","Ayanni","F","6","9",15
"13337","Azlin","F","6","9",15
"13340","Baxley","F","6","9",15
"13352","Bray","F","6","9",15
"13359","Briceyda","F","6","9",15
"13388","Carrera","F","6","9",15
"13408","Clemence","F","6","9",15
"13415","Daanya","F","6","9",15
"13418","Dalery","F","6","9",15
"13438","Delphia","F","6","9",15
"13442","Dhara","F","6","9",15
"13444","Diona","F","6","9",15
"13453","Edelin","F","6","9",15
"13455","Edina","F","6","9",15
"13463","Elizandra","F","6","9",15
"13464","Ellakate","F","6","9",15
"13472","Elvina","F","6","9",15
"13495","Evaleen","F","6","9",15
"13509","Findlay","F","6","9",15
"13512","Franklyn","F","6","9",15
"13513","Frimmy","F","6","9",15
"13532","Haeven","F","6","9",15
"13543","Haze","F","6","9",15
"13549","Hinsley","F","6","9",15
"13550","Hoor","F","6","9",15
"13567","Ivonna","F","6","9",15
"13578","Jahnya","F","6","9",15
"13592","Jazelyn","F","6","9",15
"13601","Jerriyah","F","6","9",15
"13633","Kaisy","F","6","9",15
"13638","Kalliopi","F","6","9",15
"13659","Kassidie","F","6","9",15
"13662","Kawsar","F","6","9",15
"13688","Keyonni","F","6","9",15
"13691","Khaleesia","F","6","9",15
"13694","Khamani","F","6","9",15
"13695","Khamora","F","6","9",15
"13697","Kharli","F","6","9",15
"13730","Lada","F","6","9",15
"13735","Laryn","F","6","9",15
"13739","Lauriana","F","6","9",15
"13745","Laylaa","F","6","9",15
"13752","Lenorah","F","6","9",15
"13758","Lin","F","6","9",15
"13766","Luthien","F","6","9",15
"13795","Malloree","F","6","9",15
"13799","Manisha","F","6","9",15
"13803","Mariabelen","F","6","9",15
"13810","Masey","F","6","9",15
"13825","Meli","F","6","9",15
"13831","Miamarie","F","6","9",15
"13833","Mickenzie","F","6","9",15
"13837","Milanya","F","6","9",15
"13839","Milinda","F","6","9",15
"13843","Miray","F","6","9",15
"13855","Murphie","F","6","9",15
"13856","Mushtaq","F","6","9",15
"13862","Naelani","F","6","9",15
"13878","Natividad","F","6","9",15
"13881","Nayela","F","6","9",15
"13886","Nazarene","F","6","9",15
"13890","Neri","F","6","9",15
"13903","Novalea","F","6","9",15
"13912","Otilia","F","6","9",15
"13920","Paije","F","6","9",15
"13923","Parish","F","6","9",15
"13951","Ramia","F","6","9",15
"13980","Roqaya","F","6","9",15
"13984","Roxann","F","6","9",15
"13990","Ryane","F","6","9",15
"13998","Saga","F","6","9",15
"14003","Sakshi","F","6","9",15
"14011","Saraphina","F","6","9",15
"14016","Sayda","F","6","9",15
"14038","Shyra","F","6","9",15
"14051","Soley","F","6","9",15
"14063","Stevee","F","6","9",15
"14098","Vala","F","6","9",15
"14107","Vismaya","F","6","9",15
"14108","Vyolet","F","6","9",15
"14114","Xaniyah","F","6","9",15
"14125","Yenifer","F","6","9",15
"14157","Zona","F","6","9",15
"14163","Zyelle","F","6","9",15
"14178","Aashritha","F","5","10",15
"14208","Aiyannah","F","5","10",15
"14219","Aleila","F","5","10",15
"14251","Analysse","F","5","10",15
"14254","Anastasya","F","5","10",15
"14274","Anuoluwapo","F","5","10",15
"14293","Arielly","F","5","10",15
"14324","Averii","F","5","10",15
"14331","Ayasha","F","5","10",15
"14359","Brealyn","F","5","10",15
"14373","Brookelynne","F","5","10",15
"14376","Bryssa","F","5","10",15
"14386","Cambre","F","5","10",15
"14389","Camren","F","5","10",15
"14487","Ellierose","F","5","10",15
"14492","Elyssia","F","5","10",15
"14520","Evely","F","5","10",15
"14525","Evoleth","F","5","10",15
"14535","Fairy","F","5","10",15
"14542","Firdaus","F","5","10",15
"14546","Franceska","F","5","10",15
"14563","Guliana","F","5","10",15
"14567","Gwenn","F","5","10",15
"14626","Jakaiya","F","5","10",15
"14633","Jalei","F","5","10",15
"14647","Jasmarie","F","5","10",15
"14679","Jimenna","F","5","10",15
"14682","Joel","F","5","10",15
"14703","Kailaya","F","5","10",15
"14708","Kajsa","F","5","10",15
"14755","Kindred","F","5","10",15
"14797","Leba","F","5","10",15
"14817","Livana","F","5","10",15
"14872","Marika","F","5","10",15
"14893","Meeyah","F","5","10",15
"14940","Nastassia","F","5","10",15
"14980","Olivine","F","5","10",15
"14993","Palyn","F","5","10",15
"15015","Raiyne","F","5","10",15
"15017","Ravleen","F","5","10",15
"15052","Rossie","F","5","10",15
"15060","Ruthanna","F","5","10",15
"15087","Sebastiana","F","5","10",15
"15091","Sema","F","5","10",15
"15131","Stormee","F","5","10",15
"15138","Surveen","F","5","10",15
"15148","Taryiah","F","5","10",15
"15181","Vincy","F","5","10",15
"15225","Zabella","F","5","10",15
"15249","Zeya","F","5","10",15
"15251","Zeyna","F","5","10",15
"15254","Zinachimdi","F","5","10",15
"10600","Aamari","F","9","5",14
"10620","Ahmoni","F","9","5",14
"10622","Aiana","F","9","5",14
"10632","Akiya","F","9","5",14
"10633","Akosua","F","9","5",14
"10662","Amere","F","9","5",14
"10665","Amiayah","F","9","5",14
"10678","Anicia","F","9","5",14
"10692","Areanna","F","9","5",14
"10724","Azelyn","F","9","5",14
"10736","Bostynn","F","9","5",14
"10739","Breckin","F","9","5",14
"10742","Bridgitte","F","9","5",14
"10743","Briellah","F","9","5",14
"10745","Brinda","F","9","5",14
"10750","Brittanie","F","9","5",14
"10765","Camie","F","9","5",14
"10769","Caroleena","F","9","5",14
"10771","Caselyn","F","9","5",14
"10779","Chinenye","F","9","5",14
"10787","Coleen","F","9","5",14
"10801","Damyia","F","9","5",14
"10812","Daviona","F","9","5",14
"10824","Dhani","F","9","5",14
"10835","Duru","F","9","5",14
"10867","Eriah","F","9","5",14
"10871","Ettel","F","9","5",14
"10873","Euphemia","F","9","5",14
"10894","Hadlei","F","9","5",14
"10896","Haelynn","F","9","5",14
"10908","Havah","F","9","5",14
"10932","Irelia","F","9","5",14
"10935","Isabellamarie","F","9","5",14
"10937","Isabelly","F","9","5",14
"10949","Jaelin","F","9","5",14
"10958","Jamera","F","9","5",14
"10961","Jameyah","F","9","5",14
"10976","Jenavee","F","9","5",14
"10978","Jennalynn","F","9","5",14
"10979","Jeremiah","F","9","5",14
"10985","Jesly","F","9","5",14
"10987","Jhanae","F","9","5",14
"10992","Jmarie","F","9","5",14
"10998","Joniah","F","9","5",14
"11002","Jovey","F","9","5",14
"11003","Jozee","F","9","5",14
"11005","Jumanah","F","9","5",14
"11021","Karolynn","F","9","5",14
"11033","Kaylnn","F","9","5",14
"11046","Keyleen","F","9","5",14
"11049","Khadra","F","9","5",14
"11053","Khi","F","9","5",14
"11065","Kushi","F","9","5",14
"11083","Lashonda","F","9","5",14
"11086","Laureli","F","9","5",14
"11098","Lineth","F","9","5",14
"11102","Lizzeth","F","9","5",14
"11117","Madeliene","F","9","5",14
"11121","Maidah","F","9","5",14
"11131","Malai","F","9","5",14
"11133","Malini","F","9","5",14
"11134","Mally","F","9","5",14
"11152","Maysoon","F","9","5",14
"11153","Mckinna","F","9","5",14
"11165","Milanni","F","9","5",14
"11181","Nakota","F","9","5",14
"11188","Neeka","F","9","5",14
"11195","Nohelia","F","9","5",14
"11197","Nollie","F","9","5",14
"11215","Qirat","F","9","5",14
"11228","Rayvn","F","9","5",14
"11280","Siarra","F","9","5",14
"11290","Soniyah","F","9","5",14
"11299","Sugey","F","9","5",14
"11310","Taaliah","F","9","5",14
"11318","Tatumn","F","9","5",14
"11332","Trish","F","9","5",14
"11337","Umi","F","9","5",14
"11342","Velia","F","9","5",14
"11357","Yelina","F","9","5",14
"11369","Zahniyah","F","9","5",14
"11377","Zenith","F","9","5",14
"11381","Zuree","F","9","5",14
"11402","Adeliz","F","8","6",14
"11409","Aedyn","F","8","6",14
"11411","Agam","F","8","6",14
"11413","Ahnesty","F","8","6",14
"11417","Airyn","F","8","6",14
"11419","Akaiya","F","8","6",14
"11433","Alizandra","F","8","6",14
"11445","Amylee","F","8","6",14
"11446","Anaiza","F","8","6",14
"11455","Anira","F","8","6",14
"11466","Arayia","F","8","6",14
"11467","Arayla","F","8","6",14
"11468","Arcelia","F","8","6",14
"11480","Aryian","F","8","6",14
"11486","Astryd","F","8","6",14
"11491","Atlanta","F","8","6",14
"11495","Aubrianne","F","8","6",14
"11498","Avalie","F","8","6",14
"11507","Azriella","F","8","6",14
"11508","Azyriah","F","8","6",14
"11533","Cailah","F","8","6",14
"11539","Capriana","F","8","6",14
"11541","Carey","F","8","6",14
"11554","Charlett","F","8","6",14
"11558","Charna","F","8","6",14
"11561","Chinmayi","F","8","6",14
"11562","Chris","F","8","6",14
"11565","Chyenne","F","8","6",14
"11570","Clarabella","F","8","6",14
"11573","Colton","F","8","6",14
"11587","Damilola","F","8","6",14
"11588","Damyra","F","8","6",14
"11595","Davayah","F","8","6",14
"11606","Demitria","F","8","6",14
"11608","Deveah","F","8","6",14
"11609","Dezlynn","F","8","6",14
"11615","Doha","F","8","6",14
"11621","Edelweiss","F","8","6",14
"11623","Eibhlin","F","8","6",14
"11626","Elanah","F","8","6",14
"11647","Emmilynn","F","8","6",14
"11651","Eriona","F","8","6",14
"11654","Esly","F","8","6",14
"11679","Gissele","F","8","6",14
"11684","Gracielynn","F","8","6",14
"11692","Halyn","F","8","6",14
"11694","Hannahgrace","F","8","6",14
"11695","Hansika","F","8","6",14
"11728","Jailen","F","8","6",14
"11730","Jaiona","F","8","6",14
"11739","Jamela","F","8","6",14
"11743","Janellie","F","8","6",14
"11745","Janielle","F","8","6",14
"11749","Jasmynn","F","8","6",14
"11751","Jay","F","8","6",14
"11767","Jette","F","8","6",14
"11777","Joelyn","F","8","6",14
"11787","Kaelynne","F","8","6",14
"11793","Kairy","F","8","6",14
"11813","Karri","F","8","6",14
"11828","Kenlea","F","8","6",14
"11830","Kerigan","F","8","6",14
"11841","Kizzy","F","8","6",14
"11844","Koralie","F","8","6",14
"11855","Kyonna","F","8","6",14
"11856","Kyriana","F","8","6",14
"11858","Lakai","F","8","6",14
"11860","Lamari","F","8","6",14
"11867","Layleigh","F","8","6",14
"11894","Lucee","F","8","6",14
"11900","Lyliah","F","8","6",14
"11921","Makiyla","F","8","6",14
"11924","Malayjah","F","8","6",14
"11926","Malenie","F","8","6",14
"11944","Markia","F","8","6",14
"11946","Martyna","F","8","6",14
"11958","Mayan","F","8","6",14
"11959","Mayara","F","8","6",14
"11966","Mckynleigh","F","8","6",14
"11975","Mikal","F","8","6",14
"11985","Monserat","F","8","6",14
"11992","Myleen","F","8","6",14
"11993","Naama","F","8","6",14
"12000","Nanami","F","8","6",14
"12005","Nathan","F","8","6",14
"12007","Naylaa","F","8","6",14
"12013","Neiva","F","8","6",14
"12015","Nemesis","F","8","6",14
"12016","Netta","F","8","6",14
"12021","Nigeria","F","8","6",14
"12034","Olana","F","8","6",14
"12037","Paden","F","8","6",14
"12039","Peregrine","F","8","6",14
"12041","Phynix","F","8","6",14
"12044","Presly","F","8","6",14
"12048","Raaga","F","8","6",14
"12049","Radiance","F","8","6",14
"12055","Raiven","F","8","6",14
"12076","Rithanya","F","8","6",14
"12082","Rosabel","F","8","6",14
"12086","Rozalie","F","8","6",14
"12093","Ryiah","F","8","6",14
"12095","Sabra","F","8","6",14
"12104","Sanyiah","F","8","6",14
"12108","Saryn","F","8","6",14
"12115","Shahana","F","8","6",14
"12117","Shaivi","F","8","6",14
"12128","Shelbee","F","8","6",14
"12129","Sheyenne","F","8","6",14
"12141","Socorro","F","8","6",14
"12144","Sophiea","F","8","6",14
"12152","Sumer","F","8","6",14
"12154","Supriya","F","8","6",14
"12157","Symiah","F","8","6",14
"12166","Tanyia","F","8","6",14
"12173","Terriah","F","8","6",14
"12180","Tiffanie","F","8","6",14
"12184","Trinitie","F","8","6",14
"12189","Vaniyah","F","8","6",14
"12195","Vinaya","F","8","6",14
"12196","Vivika","F","8","6",14
"12208","Yiran","F","8","6",14
"12213","Zafira","F","8","6",14
"12215","Zaily","F","8","6",14
"12217","Zakyah","F","8","6",14
"12238","Aabha","F","7","7",14
"12246","Aastha","F","7","7",14
"12250","Abisola","F","7","7",14
"12268","Ahdia","F","7","7",14
"12284","Aisleigh","F","7","7",14
"12287","Aj","F","7","7",14
"12291","Alegra","F","7","7",14
"12292","Aleira","F","7","7",14
"12302","Ameina","F","7","7",14
"12309","Anahit","F","7","7",14
"12314","Anayiah","F","7","7",14
"12324","Annisa","F","7","7",14
"12326","Antonette","F","7","7",14
"12331","Areia","F","7","7",14
"12345","Atia","F","7","7",14
"12348","Audryana","F","7","7",14
"12352","Avaa","F","7","7",14
"12356","Avena","F","7","7",14
"12365","Aysa","F","7","7",14
"12374","Bailei","F","7","7",14
"12377","Beza","F","7","7",14
"12390","Braxley","F","7","7",14
"12391","Breelan","F","7","7",14
"12392","Bren","F","7","7",14
"12396","Brin","F","7","7",14
"12397","Brinly","F","7","7",14
"12399","Britley","F","7","7",14
"12411","Cailie","F","7","7",14
"12416","Caralee","F","7","7",14
"12418","Carleen","F","7","7",14
"12419","Casia","F","7","7",14
"12422","Catalya","F","7","7",14
"12428","Chayla","F","7","7",14
"12429","Chesni","F","7","7",14
"12430","Chevie","F","7","7",14
"12445","Dariely","F","7","7",14
"12447","Dayan","F","7","7",14
"12456","Deliliah","F","7","7",14
"12458","Denaly","F","7","7",14
"12459","Denna","F","7","7",14
"12460","Derica","F","7","7",14
"12461","Derriona","F","7","7",14
"12477","Edyth","F","7","7",14
"12480","Eimi","F","7","7",14
"12485","Elen","F","7","7",14
"12489","Elisea","F","7","7",14
"12504","Emyiah","F","7","7",14
"12512","Estephany","F","7","7",14
"12514","Evalin","F","7","7",14
"12533","Gabi","F","7","7",14
"12535","Gabryela","F","7","7",14
"12541","Geonna","F","7","7",14
"12547","Graciemae","F","7","7",14
"12548","Gracious","F","7","7",14
"12549","Graecyn","F","7","7",14
"12551","Gurnaaz","F","7","7",14
"12553","Hadelyn","F","7","7",14
"12565","Hiya","F","7","7",14
"12570","Ikran","F","7","7",14
"12573","Inaayah","F","7","7",14
"12585","Izela","F","7","7",14
"12588","Jaeonna","F","7","7",14
"12594","Jakaylee","F","7","7",14
"12615","Jara","F","7","7",14
"12618","Jaselynn","F","7","7",14
"12626","Jazzalynn","F","7","7",14
"12630","Jentrie","F","7","7",14
"12632","Jermia","F","7","7",14
"12634","Jerni","F","7","7",14
"12636","Jet","F","7","7",14
"12639","Jleigh","F","7","7",14
"12646","Joley","F","7","7",14
"12652","Joylyn","F","7","7",14
"12660","Justise","F","7","7",14
"12682","Kataleyah","F","7","7",14
"12683","Katarzyna","F","7","7",14
"12691","Kayline","F","7","7",14
"12696","Keighley","F","7","7",14
"12699","Keionna","F","7","7",14
"12703","Kelty","F","7","7",14
"12705","Kendrick","F","7","7",14
"12709","Kentlee","F","7","7",14
"12711","Kevia","F","7","7",14
"12713","Keziyah","F","7","7",14
"12733","Kmarie","F","7","7",14
"12735","Korin","F","7","7",14
"12744","Kynadie","F","7","7",14
"12747","Kyrin","F","7","7",14
"12763","Lawsyn","F","7","7",14
"12766","Lean","F","7","7",14
"12768","Leialoha","F","7","7",14
"12774","Lexianna","F","7","7",14
"12775","Lezlie","F","7","7",14
"12777","Liliannah","F","7","7",14
"12778","Lilliahna","F","7","7",14
"12788","Liyanna","F","7","7",14
"12792","Loa","F","7","7",14
"12794","Lolly","F","7","7",14
"12803","Lucyann","F","7","7",14
"12805","Lylee","F","7","7",14
"12824","Makynlie","F","7","7",14
"12826","Malayasia","F","7","7",14
"12831","Marena","F","7","7",14
"12839","Maryuri","F","7","7",14
"12841","Maui","F","7","7",14
"12847","Mazlyn","F","7","7",14
"12856","Meloni","F","7","7",14
"12862","Mialani","F","7","7",14
"12864","Michaiah","F","7","7",14
"12866","Mihaela","F","7","7",14
"12870","Milenka","F","7","7",14
"12881","Monserath","F","7","7",14
"12885","Morrison","F","7","7",14
"12887","Musiq","F","7","7",14
"12891","Nadirah","F","7","7",14
"12916","Nhyira","F","7","7",14
"12928","Noelie","F","7","7",14
"12930","Nolynn","F","7","7",14
"12938","Nyimah","F","7","7",14
"12943","Oktober","F","7","7",14
"12946","Omaria","F","7","7",14
"12952","Osmara","F","7","7",14
"12959","Patty","F","7","7",14
"12981","Ralyn","F","7","7",14
"12991","Rhaelyn","F","7","7",14
"12993","Rigley","F","7","7",14
"12995","Rilei","F","7","7",14
"12996","Riverlynn","F","7","7",14
"12998","Rosalynne","F","7","7",14
"13000","Roseann","F","7","7",14
"13001","Rosebella","F","7","7",14
"13002","Rosilyn","F","7","7",14
"13007","Rushda","F","7","7",14
"13023","Sanvitha","F","7","7",14
"13037","Seraya","F","7","7",14
"13060","Sisira","F","7","7",14
"13067","Solyana","F","7","7",14
"13070","Sophira","F","7","7",14
"13077","Summerrose","F","7","7",14
"13099","Teylor","F","7","7",14
"13104","Tinzlee","F","7","7",14
"13121","Vinisha","F","7","7",14
"13122","Wakely","F","7","7",14
"13144","Yen","F","7","7",14
"13153","Yuxin","F","7","7",14
"13164","Zayonna","F","7","7",14
"13168","Zyair","F","7","7",14
"13174","Aaliyana","F","6","8",14
"13179","Abelina","F","6","8",14
"13227","Alette","F","6","8",14
"13251","Amaliya","F","6","8",14
"13255","Ambry","F","6","8",14
"13257","Amee","F","6","8",14
"13260","Amika","F","6","8",14
"13263","Amnah","F","6","8",14
"13269","Anajah","F","6","8",14
"13270","Anaria","F","6","8",14
"13273","Andilynn","F","6","8",14
"13277","Anelle","F","6","8",14
"13302","Araia","F","6","8",14
"13305","Ariarose","F","6","8",14
"13309","Arlena","F","6","8",14
"13342","Bekah","F","6","8",14
"13361","Brissia","F","6","8",14
"13370","Caelan","F","6","8",14
"13373","Calliah","F","6","8",14
"13376","Cambreigh","F","6","8",14
"13381","Caralena","F","6","8",14
"13394","Chaise","F","6","8",14
"13400","Chinaza","F","6","8",14
"13411","Cristen","F","6","8",14
"13421","Damonie","F","6","8",14
"13426","Danniela","F","6","8",14
"13429","Davinity","F","6","8",14
"13433","Dayzee","F","6","8",14
"13456","Eevie","F","6","8",14
"13459","Elayjah","F","6","8",14
"13467","Ellason","F","6","8",14
"13473","Elynor","F","6","8",14
"13490","Erie","F","6","8",14
"13498","Eveny","F","6","8",14
"13526","Graelynn","F","6","8",14
"13528","Guilianna","F","6","8",14
"13529","Gwenith","F","6","8",14
"13533","Hajira","F","6","8",14
"13536","Harrison","F","6","8",14
"13545","Henri","F","6","8",14
"13546","Hibah","F","6","8",14
"13563","Ishi","F","6","8",14
"13575","Jaelianna","F","6","8",14
"13585","Janalyn","F","6","8",14
"13587","Janetta","F","6","8",14
"13598","Jemiah","F","6","8",14
"13600","Jernie","F","6","8",14
"13608","Jinan","F","6","8",14
"13611","Joeliz","F","6","8",14
"13612","Joelynn","F","6","8",14
"13619","Julyana","F","6","8",14
"13632","Kaisleigh","F","6","8",14
"13641","Kamdynn","F","6","8",14
"13645","Kamorie","F","6","8",14
"13647","Kanai","F","6","8",14
"13655","Karyna","F","6","8",14
"13664","Kaydynce","F","6","8",14
"13666","Kayse","F","6","8",14
"13667","Kaysee","F","6","8",14
"13669","Kazi","F","6","8",14
"13675","Keiona","F","6","8",14
"13706","Kiralynn","F","6","8",14
"13723","Kynlea","F","6","8",14
"13724","Kynnlee","F","6","8",14
"13768","Lyan","F","6","8",14
"13769","Lydiana","F","6","8",14
"13772","Lyn","F","6","8",14
"13774","Lynlie","F","6","8",14
"13779","Madie","F","6","8",14
"13780","Madysin","F","6","8",14
"13783","Magdaline","F","6","8",14
"13789","Makalah","F","6","8",14
"13791","Makinzee","F","6","8",14
"13792","Mako","F","6","8",14
"13805","Markan","F","6","8",14
"13812","Mavi","F","6","8",14
"13850","Momina","F","6","8",14
"13861","Nadelyn","F","6","8",14
"13865","Nalleli","F","6","8",14
"13876","Natally","F","6","8",14
"13877","Nathalee","F","6","8",14
"13880","Naviah","F","6","8",14
"13892","Nevaen","F","6","8",14
"13897","Nimrit","F","6","8",14
"13913","Ottilia","F","6","8",14
"13961","Reha","F","6","8",14
"13965","Remedi","F","6","8",14
"13981","Rosalva","F","6","8",14
"13982","Rosary","F","6","8",14
"13983","Roselani","F","6","8",14
"13985","Ruchama","F","6","8",14
"13996","Sadiyah","F","6","8",14
"14013","Sarika","F","6","8",14
"14032","Shreenika","F","6","8",14
"14043","Simonne","F","6","8",14
"14082","Taygan","F","6","8",14
"14090","Tiarah","F","6","8",14
"14093","Torrey","F","6","8",14
"14102","Velvet","F","6","8",14
"14103","Veronique","F","6","8",14
"14106","Vincent","F","6","8",14
"14116","Xariyah","F","6","8",14
"14117","Xya","F","6","8",14
"14119","Yadhira","F","6","8",14
"14126","Yeraldine","F","6","8",14
"14127","Yichen","F","6","8",14
"14156","Zolah","F","6","8",14
"14158","Zsazsa","F","6","8",14
"14180","Abaigeal","F","5","9",14
"14201","Ahtziry","F","5","9",14
"14284","Arelys","F","5","9",14
"14286","Areni","F","5","9",14
"14307","Asna","F","5","9",14
"14309","Asyah","F","5","9",14
"14330","Avynn","F","5","9",14
"14340","Azirah","F","5","9",14
"14344","Belia","F","5","9",14
"14371","Brita","F","5","9",14
"14381","Calliana","F","5","9",14
"14387","Cambrey","F","5","9",14
"14424","Dalanie","F","5","9",14
"14445","Delancey","F","5","9",14
"14454","Dereon","F","5","9",14
"14484","Ellani","F","5","9",14
"14486","Ellieann","F","5","9",14
"14490","Ellody","F","5","9",14
"14501","Emmani","F","5","9",14
"14505","Emuna","F","5","9",14
"14521","Evelynrose","F","5","9",14
"14533","Ezrie","F","5","9",14
"14559","Greenly","F","5","9",14
"14581","Hawi","F","5","9",14
"14587","Hessa","F","5","9",14
"14588","Hibo","F","5","9",14
"14598","Ilan","F","5","9",14
"14628","Jakhia","F","5","9",14
"14630","Jalaila","F","5","9",14
"14641","Janeva","F","5","9",14
"14644","Japneet","F","5","9",14
"14654","Jaylinne","F","5","9",14
"14659","Jeannine","F","5","9",14
"14661","Jehan","F","5","9",14
"14676","Jhournee","F","5","9",14
"14689","Joules","F","5","9",14
"14700","Kaelen","F","5","9",14
"14714","Kamylle","F","5","9",14
"14717","Kaoir","F","5","9",14
"14739","Kenni","F","5","9",14
"14745","Khady","F","5","9",14
"14749","Khassidy","F","5","9",14
"14762","Kjerstin","F","5","9",14
"14782","Lamis","F","5","9",14
"14816","Lillionna","F","5","9",14
"14828","Ludmila","F","5","9",14
"14837","Mackena","F","5","9",14
"14839","Madalene","F","5","9",14
"14841","Madelon","F","5","9",14
"14847","Mahia","F","5","9",14
"14855","Makenleigh","F","5","9",14
"14890","Maziah","F","5","9",14
"14891","Mckena","F","5","9",14
"14909","Mikhayla","F","5","9",14
"14912","Milian","F","5","9",14
"14916","Misheel","F","5","9",14
"14918","Modesireoluwa","F","5","9",14
"14927","Myrakle","F","5","9",14
"14950","Neima","F","5","9",14
"14984","Oluwafikayomi","F","5","9",14
"14986","Omega","F","5","9",14
"15016","Rasika","F","5","9",14
"15020","Reana","F","5","9",14
"15024","Rehmat","F","5","9",14
"15027","Rella","F","5","9",14
"15031","Renn","F","5","9",14
"15043","Roen","F","5","9",14
"15059","Ruqayya","F","5","9",14
"15077","Sanae","F","5","9",14
"15101","Shaily","F","5","9",14
"15112","Simaya","F","5","9",14
"15114","Sirinity","F","5","9",14
"15139","Susy","F","5","9",14
"15140","Syah","F","5","9",14
"15184","Vivie","F","5","9",14
"15185","Vylet","F","5","9",14
"15189","Weston","F","5","9",14
"15198","Yacine","F","5","9",14
"15210","Yasna","F","5","9",14
"15215","Yenty","F","5","9",14
"15216","Yeraldi","F","5","9",14
"15220","Yuma","F","5","9",14
"15227","Zachary","F","5","9",14
"15228","Zaeda","F","5","9",14
"15246","Zemora","F","5","9",14
"15252","Zhoey","F","5","9",14
"15261","Zolie","F","5","9",14
"15264","Zriyah","F","5","9",14
"11385","Aakriti","F","8","5",13
"11386","Aalayiah","F","8","5",13
"11389","Aarian","F","8","5",13
"11391","Abigayl","F","8","5",13
"11393","Abrah","F","8","5",13
"11401","Adelei","F","8","5",13
"11403","Adhithi","F","8","5",13
"11420","Akiko","F","8","5",13
"11424","Aleera","F","8","5",13
"11427","Aleynna","F","8","5",13
"11436","Amai","F","8","5",13
"11439","Ambika","F","8","5",13
"11440","Ambre","F","8","5",13
"11447","Anakaren","F","8","5",13
"11454","Aneya","F","8","5",13
"11474","Arlyne","F","8","5",13
"11484","Ashonti","F","8","5",13
"11485","Asteria","F","8","5",13
"11493","Attalie","F","8","5",13
"11494","Aubreyrose","F","8","5",13
"11496","Aundraya","F","8","5",13
"11497","Aurbree","F","8","5",13
"11499","Avereigh","F","8","5",13
"11504","Ayzah","F","8","5",13
"11510","Baran","F","8","5",13
"11513","Betzabe","F","8","5",13
"11516","Blayze","F","8","5",13
"11524","Brightly","F","8","5",13
"11527","Briyana","F","8","5",13
"11531","Burkleigh","F","8","5",13
"11534","Cala","F","8","5",13
"11538","Calii","F","8","5",13
"11540","Carely","F","8","5",13
"11542","Carlea","F","8","5",13
"11543","Carliyah","F","8","5",13
"11552","Cesilia","F","8","5",13
"11559","Chelby","F","8","5",13
"11566","Cicily","F","8","5",13
"11568","Ciella","F","8","5",13
"11576","Corrin","F","8","5",13
"11583","Dalaila","F","8","5",13
"11590","Danira","F","8","5",13
"11601","Delena","F","8","5",13
"11602","Deliana","F","8","5",13
"11607","Deondra","F","8","5",13
"11613","Dinorah","F","8","5",13
"11624","Eilene","F","8","5",13
"11636","Ellyott","F","8","5",13
"11643","Embyr","F","8","5",13
"11652","Eryka","F","8","5",13
"11666","Feiga","F","8","5",13
"11671","Gabrielly","F","8","5",13
"11687","Grisel","F","8","5",13
"11697","Harshika","F","8","5",13
"11704","Hemen","F","8","5",13
"11709","Hynlee","F","8","5",13
"11711","Idania","F","8","5",13
"11712","Idil","F","8","5",13
"11721","Ivry","F","8","5",13
"11723","Jacky","F","8","5",13
"11724","Jaedah","F","8","5",13
"11731","Jaisley","F","8","5",13
"11736","Jalila","F","8","5",13
"11740","Jan","F","8","5",13
"11753","Jaylena","F","8","5",13
"11756","Jeidy","F","8","5",13
"11758","Jenayah","F","8","5",13
"11764","Jericka","F","8","5",13
"11770","Jillianne","F","8","5",13
"11775","Joclynn","F","8","5",13
"11788","Kahleesi","F","8","5",13
"11792","Kaile","F","8","5",13
"11794","Kaitlynne","F","8","5",13
"11795","Kaity","F","8","5",13
"11798","Kalianne","F","8","5",13
"11803","Kamalei","F","8","5",13
"11814","Kasi","F","8","5",13
"11817","Kataryna","F","8","5",13
"11822","Keelynn","F","8","5",13
"11842","Kmiyah","F","8","5",13
"11845","Korrine","F","8","5",13
"11850","Kseniya","F","8","5",13
"11851","Kyera","F","8","5",13
"11853","Kymoni","F","8","5",13
"11859","Lakiya","F","8","5",13
"11862","Lanaiya","F","8","5",13
"11869","Leannie","F","8","5",13
"11873","Lenayah","F","8","5",13
"11875","Leone","F","8","5",13
"11880","Lexine","F","8","5",13
"11903","Maali","F","8","5",13
"11904","Macaria","F","8","5",13
"11916","Makara","F","8","5",13
"11923","Malay","F","8","5",13
"11928","Mang","F","8","5",13
"11931","Manroop","F","8","5",13
"11934","Mariaisabella","F","8","5",13
"11943","Marjona","F","8","5",13
"11949","Maryhelen","F","8","5",13
"11963","Maymunah","F","8","5",13
"11964","Mays","F","8","5",13
"11974","Miette","F","8","5",13
"11976","Mikenzi","F","8","5",13
"11977","Mikyah","F","8","5",13
"11998","Nakira","F","8","5",13
"12014","Nelida","F","8","5",13
"12022","Ninamarie","F","8","5",13
"12023","Nineveh","F","8","5",13
"12030","Nyhla","F","8","5",13
"12038","Paizlie","F","8","5",13
"12045","Quiana","F","8","5",13
"12046","Quinci","F","8","5",13
"12077","Riza","F","8","5",13
"12078","Rockie","F","8","5",13
"12083","Rosalea","F","8","5",13
"12090","Rumor","F","8","5",13
"12098","Saki","F","8","5",13
"12100","Salimata","F","8","5",13
"12101","Samorah","F","8","5",13
"12112","Senaya","F","8","5",13
"12116","Shahina","F","8","5",13
"12122","Shavon","F","8","5",13
"12127","Shayma","F","8","5",13
"12138","Ski","F","8","5",13
"12143","Sookie","F","8","5",13
"12145","Soriyah","F","8","5",13
"12147","Srija","F","8","5",13
"12155","Sutter","F","8","5",13
"12156","Sweden","F","8","5",13
"12158","Symphanie","F","8","5",13
"12162","Talah","F","8","5",13
"12167","Taysia","F","8","5",13
"12170","Temari","F","8","5",13
"12172","Terrah","F","8","5",13
"12177","Tiah","F","8","5",13
"12186","Troy","F","8","5",13
"12193","Vianka","F","8","5",13
"12194","Vidia","F","8","5",13
"12200","Xoie","F","8","5",13
"12201","Yadelin","F","8","5",13
"12202","Yalda","F","8","5",13
"12214","Zaidy","F","8","5",13
"12231","Zoa","F","8","5",13
"12232","Zoeigh","F","8","5",13
"12242","Aamori","F","7","6",13
"12249","Abiageal","F","7","6",13
"12251","Ace","F","7","6",13
"12252","Adalen","F","7","6",13
"12261","Adlin","F","7","6",13
"12269","Ahilyn","F","7","6",13
"12277","Ai","F","7","6",13
"12283","Aireanna","F","7","6",13
"12288","Alaeyah","F","7","6",13
"12290","Alayzia","F","7","6",13
"12293","Alila","F","7","6",13
"12294","Alionna","F","7","6",13
"12296","Alreem","F","7","6",13
"12301","Ambriella","F","7","6",13
"12303","Amenia","F","7","6",13
"12308","Amyriah","F","7","6",13
"12310","Anahla","F","7","6",13
"12315","Andreina","F","7","6",13
"12321","Annalese","F","7","6",13
"12327","Anyely","F","7","6",13
"12339","Arybella","F","7","6",13
"12351","Auree","F","7","6",13
"12354","Avannah","F","7","6",13
"12359","Avorie","F","7","6",13
"12360","Avriella","F","7","6",13
"12366","Ayvree","F","7","6",13
"12370","Azrah","F","7","6",13
"12386","Bradlie","F","7","6",13
"12387","Braelin","F","7","6",13
"12389","Branna","F","7","6",13
"12393","Breyah","F","7","6",13
"12405","Brynja","F","7","6",13
"12409","Cade","F","7","6",13
"12413","Calea","F","7","6",13
"12432","Clarie","F","7","6",13
"12435","Corazon","F","7","6",13
"12446","Davaya","F","7","6",13
"12448","Dayja","F","7","6",13
"12449","Daylah","F","7","6",13
"12450","Daziah","F","7","6",13
"12452","Deidra","F","7","6",13
"12457","Demyiah","F","7","6",13
"12470","Drianna","F","7","6",13
"12472","Dyamond","F","7","6",13
"12479","Eilah","F","7","6",13
"12481","Eisleigh","F","7","6",13
"12506","Enma","F","7","6",13
"12516","Evalyse","F","7","6",13
"12527","Fatimatou","F","7","6",13
"12539","Genesi","F","7","6",13
"12558","Hansini","F","7","6",13
"12559","Harlin","F","7","6",13
"12564","Himani","F","7","6",13
"12566","Holliday","F","7","6",13
"12567","Hollynn","F","7","6",13
"12574","Inas","F","7","6",13
"12575","Infiniti","F","7","6",13
"12579","Isabele","F","7","6",13
"12580","Ishaani","F","7","6",13
"12591","Jahnia","F","7","6",13
"12592","Jaidan","F","7","6",13
"12595","Jakelin","F","7","6",13
"12596","Jakeria","F","7","6",13
"12606","Jamora","F","7","6",13
"12613","Janora","F","7","6",13
"12628","Jennavecia","F","7","6",13
"12640","Joanny","F","7","6",13
"12648","Jonnae","F","7","6",13
"12651","Jovita","F","7","6",13
"12658","Juman","F","7","6",13
"12663","Kaedynce","F","7","6",13
"12665","Kahlyn","F","7","6",13
"12677","Karlea","F","7","6",13
"12686","Kaveah","F","7","6",13
"12697","Keilianys","F","7","6",13
"12701","Kelcy","F","7","6",13
"12702","Kelsa","F","7","6",13
"12716","Khora","F","7","6",13
"12721","Khyrie","F","7","6",13
"12725","Kindra","F","7","6",13
"12736","Korinna","F","7","6",13
"12740","Krystelle","F","7","6",13
"12741","Krystin","F","7","6",13
"12742","Kymberlynn","F","7","6",13
"12750","Lakenya","F","7","6",13
"12751","Laklyn","F","7","6",13
"12758","Larimar","F","7","6",13
"12787","Lisha","F","7","6",13
"12797","Lovette","F","7","6",13
"12798","Loyalti","F","7","6",13
"12806","Lynnie","F","7","6",13
"12807","Mackenzye","F","7","6",13
"12811","Madylan","F","7","6",13
"12813","Maeryn","F","7","6",13
"12815","Maggiemae","F","7","6",13
"12816","Maham","F","7","6",13
"12822","Makhi","F","7","6",13
"12828","Malk","F","7","6",13
"12830","Malyn","F","7","6",13
"12833","Mariangela","F","7","6",13
"12843","Mayline","F","7","6",13
"12845","Maysam","F","7","6",13
"12849","Mccoy","F","7","6",13
"12855","Mellani","F","7","6",13
"12863","Michaelah","F","7","6",13
"12867","Mikeila","F","7","6",13
"12868","Mikki","F","7","6",13
"12877","Miu","F","7","6",13
"12879","Mkayla","F","7","6",13
"12886","Mumina","F","7","6",13
"12895","Najmo","F","7","6",13
"12898","Nakya","F","7","6",13
"12899","Nalea","F","7","6",13
"12911","Neeley","F","7","6",13
"12912","Neelia","F","7","6",13
"12926","Nneoma","F","7","6",13
"12931","Noralyn","F","7","6",13
"12940","Nyomie","F","7","6",13
"12949","Oren","F","7","6",13
"12950","Oria","F","7","6",13
"12958","Patton","F","7","6",13
"12961","Pearson","F","7","6",13
"12965","Portlyn","F","7","6",13
"12972","Purvi","F","7","6",13
"12984","Randee","F","7","6",13
"12986","Ravya","F","7","6",13
"12987","Reika","F","7","6",13
"12994","Riko","F","7","6",13
"12997","Rosaleah","F","7","6",13
"13005","Rukaya","F","7","6",13
"13010","Sabreena","F","7","6",13
"13013","Salam","F","7","6",13
"13017","Samaiyah","F","7","6",13
"13025","Saphyra","F","7","6",13
"13026","Sarahjane","F","7","6",13
"13031","Saveena","F","7","6",13
"13032","Sawda","F","7","6",13
"13034","Scotty","F","7","6",13
"13045","Sharae","F","7","6",13
"13056","Simrin","F","7","6",13
"13062","Skya","F","7","6",13
"13064","Skyleen","F","7","6",13
"13085","Taleigh","F","7","6",13
"13089","Tanay","F","7","6",13
"13092","Tanzila","F","7","6",13
"13097","Teraji","F","7","6",13
"13098","Teriana","F","7","6",13
"13103","Timberlee","F","7","6",13
"13107","Torey","F","7","6",13
"13112","Valena","F","7","6",13
"13118","Veralyn","F","7","6",13
"13120","Victorious","F","7","6",13
"13126","Windy","F","7","6",13
"13132","Yaelle","F","7","6",13
"13136","Yarden","F","7","6",13
"13139","Yarlin","F","7","6",13
"13148","Yorleny","F","7","6",13
"13163","Zaylen","F","7","6",13
"13165","Zian","F","7","6",13
"13176","Aaris","F","6","7",13
"13180","Abhigna","F","6","7",13
"13184","Acsa","F","6","7",13
"13189","Addiline","F","6","7",13
"13193","Adelayde","F","6","7",13
"13197","Adila","F","6","7",13
"13200","Adiyah","F","6","7",13
"13203","Adream","F","6","7",13
"13206","Adriyanna","F","6","7",13
"13211","Aishleen","F","6","7",13
"13213","Aki","F","6","7",13
"13214","Akriti","F","6","7",13
"13215","Aksha","F","6","7",13
"13219","Alee","F","6","7",13
"13225","Aleria","F","6","7",13
"13226","Aleshia","F","6","7",13
"13230","Alicyn","F","6","7",13
"13233","Alimah","F","6","7",13
"13236","Alizeh","F","6","7",13
"13241","Alliya","F","6","7",13
"13242","Allysen","F","6","7",13
"13248","Amadi","F","6","7",13
"13254","Amariss","F","6","7",13
"13264","Amrie","F","6","7",13
"13280","Anhar","F","6","7",13
"13285","Annaleese","F","6","7",13
"13296","Anyi","F","6","7",13
"13299","Aponi","F","6","7",13
"13300","Aqua","F","6","7",13
"13308","Arij","F","6","7",13
"13313","Aslan","F","6","7",13
"13314","Astyn","F","6","7",13
"13317","Aubreeanna","F","6","7",13
"13318","Aubria","F","6","7",13
"13323","Avangelina","F","6","7",13
"13324","Avayla","F","6","7",13
"13328","Avriel","F","6","7",13
"13338","Azyria","F","6","7",13
"13354","Breindel","F","6","7",13
"13365","Brizeida","F","6","7",13
"13375","Cambrea","F","6","7",13
"13384","Carman","F","6","7",13
"13386","Carolyna","F","6","7",13
"13390","Cassiel","F","6","7",13
"13392","Ceara","F","6","7",13
"13393","Ceriyah","F","6","7",13
"13402","Chloemarie","F","6","7",13
"13404","Christiane","F","6","7",13
"13405","Christyanna","F","6","7",13
"13416","Dahlya","F","6","7",13
"13440","Destynie","F","6","7",13
"13445","Dnyla","F","6","7",13
"13462","Elizabethann","F","6","7",13
"13470","Elon","F","6","7",13
"13471","Eloni","F","6","7",13
"13474","Elyzah","F","6","7",13
"13475","Elzie","F","6","7",13
"13478","Embri","F","6","7",13
"13484","Emmanuel","F","6","7",13
"13489","Erendira","F","6","7",13
"13492","Esbeydi","F","6","7",13
"13497","Evans","F","6","7",13
"13500","Fallynn","F","6","7",13
"13504","Fauna","F","6","7",13
"13508","Feyza","F","6","7",13
"13517","Galena","F","6","7",13
"13518","Gali","F","6","7",13
"13520","Genecis","F","6","7",13
"13525","Gracianna","F","6","7",13
"13531","Haden","F","6","7",13
"13551","Horizon","F","6","7",13
"13553","Hydee","F","6","7",13
"13555","Ilany","F","6","7",13
"13557","Ilma","F","6","7",13
"13560","Insiyah","F","6","7",13
"13570","Jacalyn","F","6","7",13
"13574","Jaedynn","F","6","7",13
"13577","Jahanna","F","6","7",13
"13579","Jakaila","F","6","7",13
"13580","Jakailyn","F","6","7",13
"13581","Jalana","F","6","7",13
"13584","Jamillah","F","6","7",13
"13586","Janeen","F","6","7",13
"13589","Jason","F","6","7",13
"13596","Jeilany","F","6","7",13
"13613","Joia","F","6","7",13
"13617","Joye","F","6","7",13
"13624","Kaena","F","6","7",13
"13628","Kailena","F","6","7",13
"13637","Kallan","F","6","7",13
"13640","Kambreigh","F","6","7",13
"13642","Kamella","F","6","7",13
"13644","Kamlyn","F","6","7",13
"13660","Kassy","F","6","7",13
"13663","Kaycen","F","6","7",13
"13681","Kenedee","F","6","7",13
"13685","Keslee","F","6","7",13
"13687","Keylianis","F","6","7",13
"13701","Kihara","F","6","7",13
"13705","Kindyl","F","6","7",13
"13709","Klarke","F","6","7",13
"13711","Kohana","F","6","7",13
"13719","Kween","F","6","7",13
"13728","Kytzia","F","6","7",13
"13729","Labria","F","6","7",13
"13733","Larah","F","6","7",13
"13737","Lauralynn","F","6","7",13
"13746","Laylynn","F","6","7",13
"13747","Layney","F","6","7",13
"13754","Leyonna","F","6","7",13
"13756","Lilyauna","F","6","7",13
"13759","Livinia","F","6","7",13
"13773","Lynex","F","6","7",13
"13782","Maevry","F","6","7",13
"13786","Maicie","F","6","7",13
"13787","Mairen","F","6","7",13
"13793","Malajah","F","6","7",13
"13796","Malori","F","6","7",13
"13811","Matalynn","F","6","7",13
"13815","Mayari","F","6","7",13
"13816","Maybellene","F","6","7",13
"13817","Mayven","F","6","7",13
"13820","Meesha","F","6","7",13
"13821","Meeya","F","6","7",13
"13829","Meridith","F","6","7",13
"13834","Mikeala","F","6","7",13
"13844","Mirela","F","6","7",13
"13845","Miski","F","6","7",13
"13848","Miylah","F","6","7",13
"13851","Momo","F","6","7",13
"13872","Nasia","F","6","7",13
"13875","Natalija","F","6","7",13
"13879","Natsumi","F","6","7",13
"13887","Naziah","F","6","7",13
"13889","Neoma","F","6","7",13
"13895","Nickayla","F","6","7",13
"13902","Normajean","F","6","7",13
"13904","Nyelah","F","6","7",13
"13910","Omera","F","6","7",13
"13914","Oviya","F","6","7",13
"13927","Payzleigh","F","6","7",13
"13930","Pragathi","F","6","7",13
"13933","Pranathi","F","6","7",13
"13947","Rainn","F","6","7",13
"13948","Raksha","F","6","7",13
"13949","Ramani","F","6","7",13
"13967","Rhyanna","F","6","7",13
"13970","Riyaan","F","6","7",13
"13976","Romilly","F","6","7",13
"13987","Ruqiya","F","6","7",13
"13989","Ruthvika","F","6","7",13
"14002","Sailer","F","6","7",13
"14006","Samiksha","F","6","7",13
"14014","Sarrah","F","6","7",13
"14015","Savera","F","6","7",13
"14021","Senia","F","6","7",13
"14025","Shaniece","F","6","7",13
"14037","Shyonna","F","6","7",13
"14040","Sibella","F","6","7",13
"14041","Silje","F","6","7",13
"14044","Siriah","F","6","7",13
"14047","Skyelyn","F","6","7",13
"14050","Smrithi","F","6","7",13
"14052","Solymar","F","6","7",13
"14053","Sondra","F","6","7",13
"14055","Sophronia","F","6","7",13
"14056","Sosefina","F","6","7",13
"14060","Stefanny","F","6","7",13
"14065","Suhey","F","6","7",13
"14075","Taleeya","F","6","7",13
"14078","Tammie","F","6","7",13
"14079","Tansy","F","6","7",13
"14089","Tianah","F","6","7",13
"14091","Timara","F","6","7",13
"14101","Velma","F","6","7",13
"14104","Vickie","F","6","7",13
"14109","Wendi","F","6","7",13
"14118","Xzaria","F","6","7",13
"14121","Yalina","F","6","7",13
"14129","Yoltzin","F","6","7",13
"14133","Yunalesca","F","6","7",13
"14136","Zahriah","F","6","7",13
"14139","Zamyiah","F","6","7",13
"14143","Zatanna","F","6","7",13
"14147","Zeila","F","6","7",13
"14151","Zitlali","F","6","7",13
"14160","Zuleica","F","6","7",13
"14172","Aamiya","F","5","8",13
"14175","Aarnavi","F","5","8",13
"14194","Advitha","F","5","8",13
"14197","Afreen","F","5","8",13
"14209","Ajna","F","5","8",13
"14216","Alayasia","F","5","8",13
"14226","Aljawhara","F","5","8",13
"14228","Allene","F","5","8",13
"14231","Almendra","F","5","8",13
"14239","Amiira","F","5","8",13
"14247","Anab","F","5","8",13
"14248","Analei","F","5","8",13
"14250","Analysa","F","5","8",13
"14252","Anandi","F","5","8",13
"14253","Anapaola","F","5","8",13
"14263","Aniella","F","5","8",13
"14264","Annaleia","F","5","8",13
"14299","Arlow","F","5","8",13
"14301","Aryaa","F","5","8",13
"14305","Ashani","F","5","8",13
"14306","Ashika","F","5","8",13
"14320","Avahlynn","F","5","8",13
"14321","Avalei","F","5","8",13
"14322","Avalena","F","5","8",13
"14332","Ayrin","F","5","8",13
"14335","Azaleigh","F","5","8",13
"14341","Azmariah","F","5","8",13
"14353","Bilen","F","5","8",13
"14355","Blaize","F","5","8",13
"14370","Brinklee","F","5","8",13
"14377","Cabela","F","5","8",13
"14404","Ciri","F","5","8",13
"14423","Dakiyah","F","5","8",13
"14440","Debby","F","5","8",13
"14458","Deryn","F","5","8",13
"14461","Devaeh","F","5","8",13
"14475","Eisha","F","5","8",13
"14497","Emberlie","F","5","8",13
"14513","Erioluwa","F","5","8",13
"14515","Erva","F","5","8",13
"14518","Evanny","F","5","8",13
"14524","Evin","F","5","8",13
"14531","Eyra","F","5","8",13
"14540","Felisha","F","5","8",13
"14548","Frayda","F","5","8",13
"14550","Fynlie","F","5","8",13
"14551","Gabryelle","F","5","8",13
"14569","Gyanna","F","5","8",13
"14572","Hadja","F","5","8",13
"14573","Hannan","F","5","8",13
"14574","Harlen","F","5","8",13
"14577","Hart","F","5","8",13
"14580","Havynn","F","5","8",13
"14590","Hina","F","5","8",13
"14595","Ifunanya","F","5","8",13
"14611","Irsa","F","5","8",13
"14615","Ivoree","F","5","8",13
"14620","Jaasritha","F","5","8",13
"14621","Jacksyn","F","5","8",13
"14639","Janaki","F","5","8",13
"14643","Janiyha","F","5","8",13
"14671","Jerzy","F","5","8",13
"14693","Julliette","F","5","8",13
"14694","Jun","F","5","8",13
"14699","Kaashvi","F","5","8",13
"14719","Karie","F","5","8",13
"14724","Karliyah","F","5","8",13
"14729","Kayelyn","F","5","8",13
"14732","Kaylonni","F","5","8",13
"14740","Kessley","F","5","8",13
"14741","Keylah","F","5","8",13
"14743","Keymoni","F","5","8",13
"14747","Khalis","F","5","8",13
"14775","Lahari","F","5","8",13
"14805","Lexiana","F","5","8",13
"14806","Leyda","F","5","8",13
"14808","Liberti","F","5","8",13
"14812","Lilikoi","F","5","8",13
"14813","Lilliani","F","5","8",13
"14831","Lunden","F","5","8",13
"14844","Maecy","F","5","8",13
"14856","Makinze","F","5","8",13
"14864","Malynn","F","5","8",13
"14871","Marija","F","5","8",13
"14874","Marjory","F","5","8",13
"14883","Marylouise","F","5","8",13
"14889","Mayerlin","F","5","8",13
"14896","Melaniee","F","5","8",13
"14905","Mikaiah","F","5","8",13
"14915","Miriana","F","5","8",13
"14933","Naleyah","F","5","8",13
"14942","Natilynn","F","5","8",13
"14949","Neily","F","5","8",13
"14954","Nelliel","F","5","8",13
"14959","Niana","F","5","8",13
"14973","Nykia","F","5","8",13
"14989","Oniyah","F","5","8",13
"14996","Payzley","F","5","8",13
"14997","Penni","F","5","8",13
"15001","Pooja","F","5","8",13
"15007","Qiana","F","5","8",13
"15014","Raini","F","5","8",13
"15022","Rees","F","5","8",13
"15025","Reiya","F","5","8",13
"15034","Rhyla","F","5","8",13
"15035","Rim","F","5","8",13
"15041","Ritisha","F","5","8",13
"15049","Rosealie","F","5","8",13
"15064","Ryna","F","5","8",13
"15068","Sadeen","F","5","8",13
"15081","Sarajane","F","5","8",13
"15083","Saudia","F","5","8",13
"15094","Seras","F","5","8",13
"15097","Sevi","F","5","8",13
"15110","Shya","F","5","8",13
"15111","Silvanna","F","5","8",13
"15129","Stellaluna","F","5","8",13
"15141","Syenna","F","5","8",13
"15160","Tirenioluwa","F","5","8",13
"15188","Westlynn","F","5","8",13
"15197","Xyliana","F","5","8",13
"15207","Yaniyah","F","5","8",13
"15218","Yiyi","F","5","8",13
"15219","Yovanna","F","5","8",13
"15222","Yuval","F","5","8",13
"15236","Zaraiah","F","5","8",13
"15250","Zeyla","F","5","8",13
"15262","Zorianna","F","5","8",13
"15265","Zuleimy","F","5","8",13
"12243","Aaravi","F","7","5",12
"12255","Addielynn","F","7","5",12
"12258","Adesewa","F","7","5",12
"12263","Adrijana","F","7","5",12
"12267","Afiya","F","7","5",12
"12273","Ahnalia","F","7","5",12
"12275","Ahnya","F","7","5",12
"12278","Aidaly","F","7","5",12
"12295","Alisse","F","7","5",12
"12305","Amilee","F","7","5",12
"12306","Amiliyah","F","7","5",12
"12311","Anarie","F","7","5",12
"12313","Anastassia","F","7","5",12
"12318","Angelea","F","7","5",12
"12329","Aparna","F","7","5",12
"12334","Arianis","F","7","5",12
"12342","Ashiyah","F","7","5",12
"12343","Athenea","F","7","5",12
"12346","Audelia","F","7","5",12
"12349","Audryanna","F","7","5",12
"12350","Aunalee","F","7","5",12
"12364","Ayomiposi","F","7","5",12
"12371","Azyah","F","7","5",12
"12375","Belicia","F","7","5",12
"12380","Bithiah","F","7","5",12
"12383","Blayre","F","7","5",12
"12384","Blimie","F","7","5",12
"12394","Breyonna","F","7","5",12
"12410","Cadyn","F","7","5",12
"12414","Caleena","F","7","5",12
"12423","Catherina","F","7","5",12
"12425","Ceonna","F","7","5",12
"12427","Chaselyn","F","7","5",12
"12437","Cyara","F","7","5",12
"12438","Dah","F","7","5",12
"12442","Danita","F","7","5",12
"12443","Danyell","F","7","5",12
"12451","Deeya","F","7","5",12
"12454","Delaylah","F","7","5",12
"12474","Dziyah","F","7","5",12
"12483","Elanni","F","7","5",12
"12486","Eleri","F","7","5",12
"12491","Elleah","F","7","5",12
"12498","Emerlynn","F","7","5",12
"12502","Emmelina","F","7","5",12
"12505","Enas","F","7","5",12
"12508","Enzlee","F","7","5",12
"12511","Eriyonna","F","7","5",12
"12518","Evyenia","F","7","5",12
"12519","Excel","F","7","5",12
"12521","Eyanna","F","7","5",12
"12522","Ezmay","F","7","5",12
"12525","Fany","F","7","5",12
"12538","Genelle","F","7","5",12
"12542","Gianelle","F","7","5",12
"12545","Giordana","F","7","5",12
"12546","Glorious","F","7","5",12
"12550","Graylin","F","7","5",12
"12552","Hadasha","F","7","5",12
"12555","Hagan","F","7","5",12
"12561","Heli","F","7","5",12
"12563","Hendel","F","7","5",12
"12569","Hooriya","F","7","5",12
"12572","Ilyse","F","7","5",12
"12578","Ipek","F","7","5",12
"12583","Itali","F","7","5",12
"12586","Jaeleah","F","7","5",12
"12589","Jahlayah","F","7","5",12
"12598","Jakyiah","F","7","5",12
"12599","Jalaina","F","7","5",12
"12600","Jalie","F","7","5",12
"12602","Jalynne","F","7","5",12
"12605","Jamoni","F","7","5",12
"12607","Jamyria","F","7","5",12
"12610","Janeisy","F","7","5",12
"12622","Jayel","F","7","5",12
"12631","Jera","F","7","5",12
"12642","Johileny","F","7","5",12
"12644","Jolani","F","7","5",12
"12647","Jones","F","7","5",12
"12653","Juhi","F","7","5",12
"12656","Juliyah","F","7","5",12
"12667","Kaleeya","F","7","5",12
"12670","Kalisha","F","7","5",12
"12672","Kameelah","F","7","5",12
"12674","Kampbell","F","7","5",12
"12676","Karelys","F","7","5",12
"12684","Kathalia","F","7","5",12
"12685","Katherinne","F","7","5",12
"12688","Kawena","F","7","5",12
"12689","Kaylanee","F","7","5",12
"12694","Kehaulani","F","7","5",12
"12698","Keimani","F","7","5",12
"12704","Kendelle","F","7","5",12
"12712","Keyera","F","7","5",12
"12715","Khloei","F","7","5",12
"12722","Kielyn","F","7","5",12
"12749","Lahela","F","7","5",12
"12752","Landy","F","7","5",12
"12755","Lannie","F","7","5",12
"12764","Laxmi","F","7","5",12
"12772","Leonore","F","7","5",12
"12776","Lianni","F","7","5",12
"12779","Lillienne","F","7","5",12
"12780","Lillyanah","F","7","5",12
"12781","Linah","F","7","5",12
"12782","Lindee","F","7","5",12
"12790","Lizett","F","7","5",12
"12791","Lizzette","F","7","5",12
"12808","Maclynn","F","7","5",12
"12809","Madalina","F","7","5",12
"12814","Magenta","F","7","5",12
"12825","Malae","F","7","5",12
"12834","Mariani","F","7","5",12
"12842","Mayella","F","7","5",12
"12846","Maytal","F","7","5",12
"12851","Mckyla","F","7","5",12
"12859","Merina","F","7","5",12
"12871","Miliah","F","7","5",12
"12872","Mionna","F","7","5",12
"12873","Mirae","F","7","5",12
"12874","Mirelle","F","7","5",12
"12876","Mishel","F","7","5",12
"12883","Monzerrath","F","7","5",12
"12888","Mykel","F","7","5",12
"12890","Mystic","F","7","5",12
"12897","Nakai","F","7","5",12
"12901","Nasirah","F","7","5",12
"12902","Nataleah","F","7","5",12
"12903","Natasia","F","7","5",12
"12907","Navey","F","7","5",12
"12909","Neaveh","F","7","5",12
"12910","Nechuma","F","7","5",12
"12917","Nikkie","F","7","5",12
"12920","Nikolette","F","7","5",12
"12922","Nimisha","F","7","5",12
"12942","Nzinga","F","7","5",12
"12951","Oriya","F","7","5",12
"12953","Ozioma","F","7","5",12
"12957","Pariss","F","7","5",12
"12963","Pennylane","F","7","5",12
"12969","Preslea","F","7","5",12
"12975","Rafif","F","7","5",12
"12976","Ragen","F","7","5",12
"12977","Raighan","F","7","5",12
"12980","Raiyn","F","7","5",12
"12985","Ravneet","F","7","5",12
"12992","Rheanna","F","7","5",12
"13006","Rumaysah","F","7","5",12
"13008","Ryeleigh","F","7","5",12
"13024","Saphia","F","7","5",12
"13027","Saraia","F","7","5",12
"13028","Saraiyah","F","7","5",12
"13036","Sehej","F","7","5",12
"13038","Serin","F","7","5",12
"13039","Seryna","F","7","5",12
"13041","Shalayah","F","7","5",12
"13047","Shayana","F","7","5",12
"13051","Shona","F","7","5",12
"13053","Siennah","F","7","5",12
"13054","Silvie","F","7","5",12
"13055","Simiya","F","7","5",12
"13057","Sincerity","F","7","5",12
"13061","Skailar","F","7","5",12
"13063","Skyann","F","7","5",12
"13072","Sruthi","F","7","5",12
"13076","Sulamita","F","7","5",12
"13078","Sundai","F","7","5",12
"13079","Suriah","F","7","5",12
"13080","Syleena","F","7","5",12
"13084","Talaiyah","F","7","5",12
"13091","Tanyah","F","7","5",12
"13094","Tatiyanna","F","7","5",12
"13096","Teja","F","7","5",12
"13105","Toluwanimi","F","7","5",12
"13109","Tristian","F","7","5",12
"13115","Vaniah","F","7","5",12
"13119","Veya","F","7","5",12
"13125","Wimberly","F","7","5",12
"13135","Yamari","F","7","5",12
"13138","Yarelly","F","7","5",12
"13142","Yazmyn","F","7","5",12
"13149","Yosselyn","F","7","5",12
"13150","Yuka","F","7","5",12
"13151","Yunuen","F","7","5",12
"13169","Zyannah","F","7","5",12
"13171","Aailyah","F","6","6",12
"13183","Abrina","F","6","6",12
"13187","Adam","F","6","6",12
"13188","Addasyn","F","6","6",12
"13199","Adiley","F","6","6",12
"13201","Adlen","F","6","6",12
"13202","Adonia","F","6","6",12
"13208","Aggie","F","6","6",12
"13221","Alegria","F","6","6",12
"13224","Aleni","F","6","6",12
"13232","Alilyana","F","6","6",12
"13239","Alleigha","F","6","6",12
"13245","Alyonna","F","6","6",12
"13258","Ameelia","F","6","6",12
"13259","Ameeyah","F","6","6",12
"13261","Amilli","F","6","6",12
"13262","Amitiel","F","6","6",12
"13266","Anael","F","6","6",12
"13268","Anaily","F","6","6",12
"13274","Andressa","F","6","6",12
"13275","Aneesah","F","6","6",12
"13281","Anique","F","6","6",12
"13282","Anisia","F","6","6",12
"13284","Anmol","F","6","6",12
"13290","Annarae","F","6","6",12
"13294","Antara","F","6","6",12
"13311","Ashmi","F","6","6",12
"13316","Athenarose","F","6","6",12
"13321","Autym","F","6","6",12
"13322","Avalyse","F","6","6",12
"13332","Ayen","F","6","6",12
"13333","Aylie","F","6","6",12
"13335","Aynsleigh","F","6","6",12
"13341","Becka","F","6","6",12
"13346","Bess","F","6","6",12
"13353","Braylah","F","6","6",12
"13355","Brelee","F","6","6",12
"13356","Brenlie","F","6","6",12
"13357","Brexlyn","F","6","6",12
"13366","Brooklen","F","6","6",12
"13368","Bryony","F","6","6",12
"13371","Cailen","F","6","6",12
"13372","Calley","F","6","6",12
"13387","Carrah","F","6","6",12
"13389","Casidee","F","6","6",12
"13398","Charliegh","F","6","6",12
"13403","Christabelle","F","6","6",12
"13412","Cristian","F","6","6",12
"13420","Damariz","F","6","6",12
"13422","Danahi","F","6","6",12
"13423","Danaria","F","6","6",12
"13435","Deajah","F","6","6",12
"13439","Denisa","F","6","6",12
"13441","Deyjah","F","6","6",12
"13443","Dilcia","F","6","6",12
"13449","Drusilla","F","6","6",12
"13452","Edee","F","6","6",12
"13458","Elanore","F","6","6",12
"13465","Ellany","F","6","6",12
"13482","Emmaclaire","F","6","6",12
"13485","Emonni","F","6","6",12
"13488","Eponine","F","6","6",12
"13493","Esmarie","F","6","6",12
"13494","Eula","F","6","6",12
"13505","Faylinn","F","6","6",12
"13507","Felicitas","F","6","6",12
"13523","Ghita","F","6","6",12
"13554","Idman","F","6","6",12
"13558","Indee","F","6","6",12
"13561","Irelynd","F","6","6",12
"13565","Ivan","F","6","6",12
"13568","Izelle","F","6","6",12
"13573","Jadesola","F","6","6",12
"13583","Jamiee","F","6","6",12
"13594","Jazzlyne","F","6","6",12
"13606","Jhourni","F","6","6",12
"13609","Jirah","F","6","6",12
"13615","Jordon","F","6","6",12
"13629","Kailiyah","F","6","6",12
"13631","Kairie","F","6","6",12
"13636","Kalinda","F","6","6",12
"13639","Kalypso","F","6","6",12
"13651","Karleen","F","6","6",12
"13653","Karmann","F","6","6",12
"13672","Kealia","F","6","6",12
"13676","Keirstin","F","6","6",12
"13679","Kember","F","6","6",12
"13680","Kendria","F","6","6",12
"13682","Kennedii","F","6","6",12
"13684","Keriana","F","6","6",12
"13686","Keyarra","F","6","6",12
"13689","Keyrin","F","6","6",12
"13707","Klare","F","6","6",12
"13708","Klarisa","F","6","6",12
"13712","Kole","F","6","6",12
"13725","Kyomi","F","6","6",12
"13726","Kyren","F","6","6",12
"13732","Lakeisha","F","6","6",12
"13736","Lashawn","F","6","6",12
"13744","Laykyn","F","6","6",12
"13748","Leanah","F","6","6",12
"13750","Leiann","F","6","6",12
"13751","Leilanii","F","6","6",12
"13755","Libny","F","6","6",12
"13760","Lohgan","F","6","6",12
"13761","Lorrie","F","6","6",12
"13771","Lylarose","F","6","6",12
"13776","Lyrics","F","6","6",12
"13788","Majestic","F","6","6",12
"13794","Malisa","F","6","6",12
"13801","Marajade","F","6","6",12
"13802","Mareya","F","6","6",12
"13806","Markita","F","6","6",12
"13814","Mayana","F","6","6",12
"13818","Mckynzi","F","6","6",12
"13819","Mechelle","F","6","6",12
"13835","Mikia","F","6","6",12
"13840","Millani","F","6","6",12
"13841","Minaal","F","6","6",12
"13842","Minh","F","6","6",12
"13847","Miyla","F","6","6",12
"13867","Namiah","F","6","6",12
"13870","Nanako","F","6","6",12
"13871","Nash","F","6","6",12
"13873","Nasro","F","6","6",12
"13874","Natacha","F","6","6",12
"13883","Naylee","F","6","6",12
"13893","Niamiah","F","6","6",12
"13894","Niani","F","6","6",12
"13899","Noellie","F","6","6",12
"13906","Ogechi","F","6","6",12
"13907","Olamiposi","F","6","6",12
"13908","Olesya","F","6","6",12
"13911","Oonagh","F","6","6",12
"13917","Ozzie","F","6","6",12
"13921","Paisleyann","F","6","6",12
"13922","Pallavi","F","6","6",12
"13926","Paytan","F","6","6",12
"13931","Pragna","F","6","6",12
"13934","Prezley","F","6","6",12
"13936","Prisila","F","6","6",12
"13943","Quinnlynn","F","6","6",12
"13945","Rael","F","6","6",12
"13950","Ramatoulaye","F","6","6",12
"13959","Razia","F","6","6",12
"13963","Reiko","F","6","6",12
"13969","Rieley","F","6","6",12
"13973","Romana","F","6","6",12
"13977","Ronda","F","6","6",12
"13991","Sabeen","F","6","6",12
"13994","Sadieann","F","6","6",12
"13999","Sahej","F","6","6",12
"14004","Saleha","F","6","6",12
"14007","Sandrine","F","6","6",12
"14008","Sanora","F","6","6",12
"14009","Saraii","F","6","6",12
"14010","Sarang","F","6","6",12
"14018","Sean","F","6","6",12
"14030","Shila","F","6","6",12
"14031","Shoni","F","6","6",12
"14036","Shylie","F","6","6",12
"14042","Silva","F","6","6",12
"14046","Skyanna","F","6","6",12
"14048","Skyley","F","6","6",12
"14057","Sparkle","F","6","6",12
"14061","Steisy","F","6","6",12
"14062","Stellar","F","6","6",12
"14066","Summerlynn","F","6","6",12
"14067","Suzi","F","6","6",12
"14068","Svara","F","6","6",12
"14070","Sylar","F","6","6",12
"14073","Tahj","F","6","6",12
"14076","Tamanna","F","6","6",12
"14077","Tamina","F","6","6",12
"14080","Taralyn","F","6","6",12
"14081","Tatelyn","F","6","6",12
"14083","Tayva","F","6","6",12
"14084","Tejasvi","F","6","6",12
"14086","Terrionna","F","6","6",12
"14088","Thanya","F","6","6",12
"14092","Tonantzin","F","6","6",12
"14094","Tristine","F","6","6",12
"14097","Umme","F","6","6",12
"14105","Victoriana","F","6","6",12
"14111","Wiktoria","F","6","6",12
"14112","Winterrose","F","6","6",12
"14113","Witten","F","6","6",12
"14115","Xanthe","F","6","6",12
"14132","Yumiko","F","6","6",12
"14141","Zareena","F","6","6",12
"14142","Zaryia","F","6","6",12
"14144","Zaveah","F","6","6",12
"14145","Zaydah","F","6","6",12
"14148","Zephyra","F","6","6",12
"14154","Zoel","F","6","6",12
"14159","Zsofia","F","6","6",12
"14164","Zyionna","F","6","6",12
"14165","Zyleigh","F","6","6",12
"14176","Aaruhi","F","5","7",12
"14177","Aaryahi","F","5","7",12
"14198","Ahnesti","F","5","7",12
"14206","Aisosa","F","5","7",12
"14210","Akeria","F","5","7",12
"14215","Alashia","F","5","7",12
"14218","Aleezah","F","5","7",12
"14224","Alithia","F","5","7",12
"14225","Alizea","F","5","7",12
"14233","Aloria","F","5","7",12
"14236","Amadea","F","5","7",12
"14241","Amit","F","5","7",12
"14259","Anberlyn","F","5","7",12
"14269","Annely","F","5","7",12
"14272","Annikah","F","5","7",12
"14278","Araeya","F","5","7",12
"14285","Arena","F","5","7",12
"14288","Areyah","F","5","7",12
"14289","Arhianna","F","5","7",12
"14297","Arlana","F","5","7",12
"14315","Audrena","F","5","7",12
"14319","Avaeh","F","5","7",12
"14323","Avalin","F","5","7",12
"14329","Avreet","F","5","7",12
"14342","Bailea","F","5","7",12
"14345","Belize","F","5","7",12
"14351","Beverley","F","5","7",12
"14352","Bexli","F","5","7",12
"14360","Breck","F","5","7",12
"14362","Brendalynn","F","5","7",12
"14363","Brenlyn","F","5","7",12
"14368","Brianni","F","5","7",12
"14379","Calah","F","5","7",12
"14393","Castiel","F","5","7",12
"14395","Cecilya","F","5","7",12
"14407","Clarita","F","5","7",12
"14412","Cove","F","5","7",12
"14419","Daena","F","5","7",12
"14425","Daleigh","F","5","7",12
"14426","Daleth","F","5","7",12
"14427","Dalyn","F","5","7",12
"14432","Danniella","F","5","7",12
"14437","Dazaria","F","5","7",12
"14438","Deaja","F","5","7",12
"14441","Deegan","F","5","7",12
"14444","Delailah","F","5","7",12
"14448","Delphina","F","5","7",12
"14449","Demani","F","5","7",12
"14457","Derriana","F","5","7",12
"14463","Devoiry","F","5","7",12
"14464","Devonna","F","5","7",12
"14468","Diandra","F","5","7",12
"14469","Digna","F","5","7",12
"14481","Eliska","F","5","7",12
"14511","Erilyn","F","5","7",12
"14516","Evaleena","F","5","7",12
"14522","Everlei","F","5","7",12
"14530","Exodus","F","5","7",12
"14537","Fate","F","5","7",12
"14549","Fynley","F","5","7",12
"14566","Gwenevieve","F","5","7",12
"14583","Heartly","F","5","7",12
"14600","Iliani","F","5","7",12
"14607","Iolani","F","5","7",12
"14610","Ireri","F","5","7",12
"14613","Itzuri","F","5","7",12
"14637","Jamella","F","5","7",12
"14640","Janari","F","5","7",12
"14649","Javia","F","5","7",12
"14651","Jayd","F","5","7",12
"14653","Jaylianis","F","5","7",12
"14656","Jazae","F","5","7",12
"14658","Jazzy","F","5","7",12
"14663","Jenalise","F","5","7",12
"14669","Jerriah","F","5","7",12
"14670","Jersei","F","5","7",12
"14686","Jonier","F","5","7",12
"14692","Jullian","F","5","7",12
"14711","Kamariya","F","5","7",12
"14742","Keylen","F","5","7",12
"14761","Kirklyn","F","5","7",12
"14763","Klaryssa","F","5","7",12
"14773","Krissia","F","5","7",12
"14777","Laionna","F","5","7",12
"14778","Laiylah","F","5","7",12
"14779","Lakenzie","F","5","7",12
"14787","Lateen","F","5","7",12
"14789","Laurelin","F","5","7",12
"14791","Layia","F","5","7",12
"14793","Laziyah","F","5","7",12
"14822","Louann","F","5","7",12
"14823","Louie","F","5","7",12
"14826","Lucianne","F","5","7",12
"14827","Luciella","F","5","7",12
"14833","Lyanne","F","5","7",12
"14834","Lyleigh","F","5","7",12
"14836","Maaya","F","5","7",12
"14851","Mairi","F","5","7",12
"14857","Makynley","F","5","7",12
"14866","Marai","F","5","7",12
"14873","Marisabel","F","5","7",12
"14875","Marlayah","F","5","7",12
"14876","Marleyna","F","5","7",12
"14879","Marry","F","5","7",12
"14884","Masiya","F","5","7",12
"14885","Maty","F","5","7",12
"14887","Mayce","F","5","7",12
"14888","Maydelin","F","5","7",12
"14892","Mckinzley","F","5","7",12
"14898","Mercie","F","5","7",12
"14907","Mikayah","F","5","7",12
"14914","Milliani","F","5","7",12
"14921","Moyinoluwa","F","5","7",12
"14923","Myers","F","5","7",12
"14924","Mykenna","F","5","7",12
"14928","Naeva","F","5","7",12
"14930","Naija","F","5","7",12
"14936","Nare","F","5","7",12
"14952","Neleh","F","5","7",12
"14957","Nevena","F","5","7",12
"14967","Niyonna","F","5","7",12
"14970","Novaly","F","5","7",12
"14972","Nyarie","F","5","7",12
"14976","Nyrah","F","5","7",12
"14977","Oakland","F","5","7",12
"14987","Onesti","F","5","7",12
"14990","Onyinyechukwu","F","5","7",12
"14994","Panagiota","F","5","7",12
"14998","Peony","F","5","7",12
"15000","Pippin","F","5","7",12
"15002","Portland","F","5","7",12
"15009","Raaya","F","5","7",12
"15018","Rayli","F","5","7",12
"15023","Rehema","F","5","7",12
"15028","Remii","F","5","7",12
"15029","Remilynn","F","5","7",12
"15030","Reminisce","F","5","7",12
"15036","Rinka","F","5","7",12
"15044","Roha","F","5","7",12
"15045","Roiza","F","5","7",12
"15048","Rosaisela","F","5","7",12
"15072","Salsabeel","F","5","7",12
"15074","Samani","F","5","7",12
"15078","Sandi","F","5","7",12
"15085","Saundra","F","5","7",12
"15088","Seham","F","5","7",12
"15099","Shaanvi","F","5","7",12
"15102","Shama","F","5","7",12
"15115","Siriyah","F","5","7",12
"15145","Tamila","F","5","7",12
"15146","Tanasia","F","5","7",12
"15147","Tanylah","F","5","7",12
"15150","Tayelor","F","5","7",12
"15155","Thailyn","F","5","7",12
"15161","Tirza","F","5","7",12
"15164","Treva","F","5","7",12
"15165","Trianna","F","5","7",12
"15171","Tyriana","F","5","7",12
"15176","Vannesa","F","5","7",12
"15191","Wryn","F","5","7",12
"15194","Xavier","F","5","7",12
"15202","Yali","F","5","7",12
"15209","Yariah","F","5","7",12
"15221","Yurianna","F","5","7",12
"15224","Zabdi","F","5","7",12
"15237","Zavia","F","5","7",12
"15242","Zayn","F","5","7",12
"15243","Zayne","F","5","7",12
"15248","Zephora","F","5","7",12
"13173","Aaliana","F","6","5",11
"13178","Abela","F","6","5",11
"13182","Abiola","F","6","5",11
"13186","Adaleia","F","6","5",11
"13192","Adelayda","F","6","5",11
"13207","Adut","F","6","5",11
"13218","Aldina","F","6","5",11
"13222","Aleighya","F","6","5",11
"13228","Alexius","F","6","5",11
"13234","Aliss","F","6","5",11
"13235","Aliyaah","F","6","5",11
"13237","Alle","F","6","5",11
"13240","Allinson","F","6","5",11
"13247","Amabelle","F","6","5",11
"13249","Amairah","F","6","5",11
"13253","Amarielle","F","6","5",11
"13256","Amea","F","6","5",11
"13267","Anaiis","F","6","5",11
"13287","Annalya","F","6","5",11
"13288","Annalysia","F","6","5",11
"13289","Annapurna","F","6","5",11
"13291","Anndrea","F","6","5",11
"13293","Anoop","F","6","5",11
"13295","Anthonia","F","6","5",11
"13301","Arai","F","6","5",11
"13303","Ardis","F","6","5",11
"13306","Ariba","F","6","5",11
"13307","Arieal","F","6","5",11
"13312","Ashya","F","6","5",11
"13319","Audreanna","F","6","5",11
"13325","Aveen","F","6","5",11
"13326","Averylynn","F","6","5",11
"13327","Aviree","F","6","5",11
"13329","Ayak","F","6","5",11
"13336","Azaelia","F","6","5",11
"13339","Bahja","F","6","5",11
"13348","Bintu","F","6","5",11
"13349","Bleu","F","6","5",11
"13351","Bralee","F","6","5",11
"13358","Brezlyn","F","6","5",11
"13360","Brinslee","F","6","5",11
"13364","Briyith","F","6","5",11
"13369","Burklee","F","6","5",11
"13378","Camyra","F","6","5",11
"13379","Candyce","F","6","5",11
"13380","Caragh","F","6","5",11
"13385","Carmilla","F","6","5",11
"13391","Cathaleya","F","6","5",11
"13397","Channelle","F","6","5",11
"13399","Cherith","F","6","5",11
"13406","Cicilia","F","6","5",11
"13407","Cipriana","F","6","5",11
"13409","Cloris","F","6","5",11
"13410","Corrinne","F","6","5",11
"13417","Daionna","F","6","5",11
"13425","Danique","F","6","5",11
"13428","Dasiya","F","6","5",11
"13430","Dax","F","6","5",11
"13432","Daysie","F","6","5",11
"13434","Dazie","F","6","5",11
"13436","Deeanna","F","6","5",11
"13437","Deidre","F","6","5",11
"13447","Dorthy","F","6","5",11
"13448","Dreanna","F","6","5",11
"13450","Dyna","F","6","5",11
"13451","Eastynn","F","6","5",11
"13454","Edessa","F","6","5",11
"13460","Elcie","F","6","5",11
"13461","Elidia","F","6","5",11
"13468","Ellyanah","F","6","5",11
"13469","Ellys","F","6","5",11
"13476","Emanuelle","F","6","5",11
"13479","Emera","F","6","5",11
"13480","Emerii","F","6","5",11
"13496","Evann","F","6","5",11
"13499","Evienne","F","6","5",11
"13501","Fardosa","F","6","5",11
"13502","Faria","F","6","5",11
"13506","Fedora","F","6","5",11
"13510","Fiorela","F","6","5",11
"13515","Gaige","F","6","5",11
"13516","Galadriel","F","6","5",11
"13519","Gavrielle","F","6","5",11
"13521","Geri","F","6","5",11
"13524","Giah","F","6","5",11
"13530","Haadiya","F","6","5",11
"13535","Hannalee","F","6","5",11
"13537","Harseerat","F","6","5",11
"13540","Harvi","F","6","5",11
"13542","Hayvin","F","6","5",11
"13559","Indiyah","F","6","5",11
"13572","Jacobi","F","6","5",11
"13576","Jaely","F","6","5",11
"13590","Jaylissa","F","6","5",11
"13593","Jazira","F","6","5",11
"13595","Jazzmyne","F","6","5",11
"13597","Jeleah","F","6","5",11
"13599","Jemina","F","6","5",11
"13602","Jeslin","F","6","5",11
"13603","Jessabella","F","6","5",11
"13604","Jeyda","F","6","5",11
"13605","Jezel","F","6","5",11
"13614","Joliet","F","6","5",11
"13618","Jozy","F","6","5",11
"13622","Kadia","F","6","5",11
"13626","Kahlee","F","6","5",11
"13627","Kaielle","F","6","5",11
"13634","Kalicia","F","6","5",11
"13643","Kamerin","F","6","5",11
"13646","Kamsiyochi","F","6","5",11
"13648","Kanijah","F","6","5",11
"13649","Karee","F","6","5",11
"13650","Karianne","F","6","5",11
"13657","Kaselynn","F","6","5",11
"13658","Kasen","F","6","5",11
"13665","Kaylonie","F","6","5",11
"13668","Kayzlie","F","6","5",11
"13674","Keilynn","F","6","5",11
"13677","Kelena","F","6","5",11
"13683","Keria","F","6","5",11
"13690","Khaira","F","6","5",11
"13692","Khalil","F","6","5",11
"13693","Khalynn","F","6","5",11
"13699","Khianna","F","6","5",11
"13704","Kindal","F","6","5",11
"13710","Knyla","F","6","5",11
"13715","Krisley","F","6","5",11
"13716","Kristabella","F","6","5",11
"13717","Krupa","F","6","5",11
"13718","Krystle","F","6","5",11
"13720","Kylina","F","6","5",11
"13721","Kymari","F","6","5",11
"13727","Kyriel","F","6","5",11
"13734","Larsyn","F","6","5",11
"13738","Lauran","F","6","5",11
"13742","Layden","F","6","5",11
"13743","Layiah","F","6","5",11
"13757","Lima","F","6","5",11
"13763","Lujane","F","6","5",11
"13765","Lunarae","F","6","5",11
"13767","Luvina","F","6","5",11
"13775","Lynora","F","6","5",11
"13777","Macelynn","F","6","5",11
"13778","Macilynn","F","6","5",11
"13790","Makhyla","F","6","5",11
"13800","Marae","F","6","5",11
"13804","Marine","F","6","5",11
"13808","Marleyann","F","6","5",11
"13809","Marlii","F","6","5",11
"13822","Meital","F","6","5",11
"13823","Meiya","F","6","5",11
"13827","Melita","F","6","5",11
"13830","Meriwether","F","6","5",11
"13846","Miyani","F","6","5",11
"13853","Motunrayo","F","6","5",11
"13854","Munisa","F","6","5",11
"13858","Myca","F","6","5",11
"13860","Mythili","F","6","5",11
"13863","Nahlani","F","6","5",11
"13866","Namia","F","6","5",11
"13882","Naylanie","F","6","5",11
"13884","Nayyirah","F","6","5",11
"13891","Nerriah","F","6","5",11
"13896","Nikka","F","6","5",11
"13900","Noria","F","6","5",11
"13901","Noriana","F","6","5",11
"13915","Owyn","F","6","5",11
"13918","Pace","F","6","5",11
"13919","Paelynn","F","6","5",11
"13924","Patti","F","6","5",11
"13925","Payeton","F","6","5",11
"13929","Petal","F","6","5",11
"13937","Pristine","F","6","5",11
"13938","Pritika","F","6","5",11
"13940","Quianna","F","6","5",11
"13941","Quincie","F","6","5",11
"13942","Quinne","F","6","5",11
"13944","Raeden","F","6","5",11
"13955","Rashi","F","6","5",11
"13956","Ravynn","F","6","5",11
"13957","Raylah","F","6","5",11
"13968","Riata","F","6","5",11
"13972","Robiya","F","6","5",11
"13992","Sabela","F","6","5",11
"13997","Saelor","F","6","5",11
"14001","Saidah","F","6","5",11
"14017","Scarlotte","F","6","5",11
"14019","Selen","F","6","5",11
"14020","Semaya","F","6","5",11
"14024","Shahzoda","F","6","5",11
"14026","Shanyah","F","6","5",11
"14028","Shayda","F","6","5",11
"14034","Shrita","F","6","5",11
"14035","Shritha","F","6","5",11
"14049","Skyye","F","6","5",11
"14058","Sristi","F","6","5",11
"14069","Sya","F","6","5",11
"14071","Symphani","F","6","5",11
"14074","Talayla","F","6","5",11
"14085","Temitope","F","6","5",11
"14087","Teuila","F","6","5",11
"14095","Tylayah","F","6","5",11
"14096","Tylin","F","6","5",11
"14120","Yahvi","F","6","5",11
"14122","Yassmine","F","6","5",11
"14123","Yeilani","F","6","5",11
"14124","Yeiri","F","6","5",11
"14128","Yina","F","6","5",11
"14130","Yovana","F","6","5",11
"14137","Zakyrah","F","6","5",11
"14138","Zamani","F","6","5",11
"14146","Zeah","F","6","5",11
"14150","Zhoie","F","6","5",11
"14152","Zixuan","F","6","5",11
"14153","Zlaty","F","6","5",11
"14166","Zymiah","F","6","5",11
"14173","Aania","F","5","6",11
"14185","Acey","F","5","6",11
"14189","Adelis","F","5","6",11
"14190","Adiel","F","5","6",11
"14191","Adilena","F","5","6",11
"14195","Adylen","F","5","6",11
"14211","Aksa","F","5","6",11
"14213","Akyah","F","5","6",11
"14214","Alaria","F","5","6",11
"14217","Aldana","F","5","6",11
"14220","Aletha","F","5","6",11
"14221","Alexandrya","F","5","6",11
"14229","Allyce","F","5","6",11
"14235","Alyshia","F","5","6",11
"14237","Amali","F","5","6",11
"14242","Ammie","F","5","6",11
"14243","Amoriana","F","5","6",11
"14245","Amyna","F","5","6",11
"14249","Analuisa","F","5","6",11
"14268","Annayah","F","5","6",11
"14275","Anwyn","F","5","6",11
"14276","Apsara","F","5","6",11
"14280","Aram","F","5","6",11
"14292","Arieah","F","5","6",11
"14295","Ariyelle","F","5","6",11
"14300","Arriella","F","5","6",11
"14302","Aseret","F","5","6",11
"14303","Aset","F","5","6",11
"14304","Asfiya","F","5","6",11
"14310","Atalee","F","5","6",11
"14312","Attica","F","5","6",11
"14314","Aubryella","F","5","6",11
"14317","Aundreya","F","5","6",11
"14328","Avlyn","F","5","6",11
"14338","Azella","F","5","6",11
"14346","Bellaann","F","5","6",11
"14348","Beni","F","5","6",11
"14357","Blimi","F","5","6",11
"14361","Breeley","F","5","6",11
"14364","Brennyn","F","5","6",11
"14374","Brylen","F","5","6",11
"14378","Caedence","F","5","6",11
"14380","Calirae","F","5","6",11
"14383","Calvary","F","5","6",11
"14390","Carin","F","5","6",11
"14398","Chaarvi","F","5","6",11
"14410","Corynne","F","5","6",11
"14411","Courtland","F","5","6",11
"14413","Cylah","F","5","6",11
"14414","Cynai","F","5","6",11
"14418","Daania","F","5","6",11
"14429","Dane","F","5","6",11
"14430","Daneen","F","5","6",11
"14434","Daryna","F","5","6",11
"14439","Deandria","F","5","6",11
"14442","Deilani","F","5","6",11
"14446","Delayah","F","5","6",11
"14455","Deriana","F","5","6",11
"14456","Dericka","F","5","6",11
"14462","Devlynn","F","5","6",11
"14465","Devory","F","5","6",11
"14473","Eduarda","F","5","6",11
"14474","Eimaan","F","5","6",11
"14476","Eliahna","F","5","6",11
"14477","Elianni","F","5","6",11
"14489","Elliyanna","F","5","6",11
"14491","Elna","F","5","6",11
"14494","Emanie","F","5","6",11
"14496","Emanuel","F","5","6",11
"14498","Emerleigh","F","5","6",11
"14499","Emilene","F","5","6",11
"14500","Emilygrace","F","5","6",11
"14502","Emmeryn","F","5","6",11
"14503","Emmilou","F","5","6",11
"14507","Enessa","F","5","6",11
"14512","Erilynn","F","5","6",11
"14519","Eveah","F","5","6",11
"14528","Evvy","F","5","6",11
"14529","Evynne","F","5","6",11
"14532","Ezinne","F","5","6",11
"14536","Farris","F","5","6",11
"14543","Firdaws","F","5","6",11
"14544","Forest","F","5","6",11
"14547","Franziska","F","5","6",11
"14552","Gamila","F","5","6",11
"14556","Gianah","F","5","6",11
"14557","Giyanna","F","5","6",11
"14558","Graycelyn","F","5","6",11
"14562","Gricelda","F","5","6",11
"14564","Gunnar","F","5","6",11
"14568","Gwenna","F","5","6",11
"14575","Harlequin","F","5","6",11
"14576","Harlequinn","F","5","6",11
"14578","Harumi","F","5","6",11
"14585","Heavenli","F","5","6",11
"14586","Helia","F","5","6",11
"14599","Ileigh","F","5","6",11
"14604","Independence","F","5","6",11
"14605","Intisar","F","5","6",11
"14612","Italee","F","5","6",11
"14614","Itzy","F","5","6",11
"14616","Izara","F","5","6",11
"14617","Izna","F","5","6",11
"14618","Izora","F","5","6",11
"14619","Jaasia","F","5","6",11
"14627","Jakara","F","5","6",11
"14631","Jalasia","F","5","6",11
"14638","Janais","F","5","6",11
"14648","Javae","F","5","6",11
"14652","Jaydy","F","5","6",11
"14666","Jennabelle","F","5","6",11
"14674","Jeyla","F","5","6",11
"14675","Jeylah","F","5","6",11
"14678","Jilliann","F","5","6",11
"14680","Jionna","F","5","6",11
"14681","Jiwoo","F","5","6",11
"14688","Joselle","F","5","6",11
"14691","Juliyana","F","5","6",11
"14695","Justin","F","5","6",11
"14697","Juwairiyah","F","5","6",11
"14698","Jwan","F","5","6",11
"14701","Kahliya","F","5","6",11
"14705","Kairo","F","5","6",11
"14706","Kaisey","F","5","6",11
"14709","Kalirose","F","5","6",11
"14715","Kandy","F","5","6",11
"14716","Kanya","F","5","6",11
"14718","Karenna","F","5","6",11
"14720","Karielys","F","5","6",11
"14721","Karimah","F","5","6",11
"14725","Kasima","F","5","6",11
"14726","Kasiya","F","5","6",11
"14730","Kaylenn","F","5","6",11
"14731","Kayliani","F","5","6",11
"14734","Kekeli","F","5","6",11
"14735","Kemaria","F","5","6",11
"14738","Keniah","F","5","6",11
"14744","Keyoni","F","5","6",11
"14750","Khodi","F","5","6",11
"14751","Khylin","F","5","6",11
"14752","Kila","F","5","6",11
"14753","Kimberleigh","F","5","6",11
"14759","Kioni","F","5","6",11
"14764","Kohen","F","5","6",11
"14765","Kolbee","F","5","6",11
"14767","Korbin","F","5","6",11
"14768","Korianna","F","5","6",11
"14774","Ky","F","5","6",11
"14776","Lailana","F","5","6",11
"14780","Lakia","F","5","6",11
"14781","Lakshana","F","5","6",11
"14784","Lan","F","5","6",11
"14785","Lanette","F","5","6",11
"14792","Laylana","F","5","6",11
"14801","Leianah","F","5","6",11
"14803","Lesleigh","F","5","6",11
"14807","Liahona","F","5","6",11
"14811","Liliauna","F","5","6",11
"14818","Loida","F","5","6",11
"14819","Lojain","F","5","6",11
"14821","Lorinda","F","5","6",11
"14835","Lyricc","F","5","6",11
"14840","Madelena","F","5","6",11
"14848","Mahkayla","F","5","6",11
"14849","Mahli","F","5","6",11
"14858","Malaijah","F","5","6",11
"14860","Maleea","F","5","6",11
"14868","Mariadejesus","F","5","6",11
"14869","Marialena","F","5","6",11
"14870","Mariea","F","5","6",11
"14877","Marliee","F","5","6",11
"14882","Maryjean","F","5","6",11
"14886","Maybrie","F","5","6",11
"14895","Meka","F","5","6",11
"14897","Meliza","F","5","6",11
"14899","Mercury","F","5","6",11
"14906","Mikalyn","F","5","6",11
"14910","Milanee","F","5","6",11
"14913","Miliany","F","5","6",11
"14917","Mithila","F","5","6",11
"14919","Moncerrat","F","5","6",11
"14932","Nakari","F","5","6",11
"14941","Natalea","F","5","6",11
"14945","Nazari","F","5","6",11
"14948","Neeya","F","5","6",11
"14951","Nekoda","F","5","6",11
"14958","Nevina","F","5","6",11
"14963","Nike","F","5","6",11
"14964","Nikkole","F","5","6",11
"14971","Nusaibah","F","5","6",11
"14974","Nyonna","F","5","6",11
"14975","Nyota","F","5","6",11
"14978","Oaklea","F","5","6",11
"14979","Okalani","F","5","6",11
"14995","Pasleigh","F","5","6",11
"14999","Phenyx","F","5","6",11
"15006","Priyah","F","5","6",11
"15012","Raeonna","F","5","6",11
"15013","Rahil","F","5","6",11
"15033","Rhaegan","F","5","6",11
"15050","Roselena","F","5","6",11
"15051","Rosha","F","5","6",11
"15057","Ruhee","F","5","6",11
"15063","Ryin","F","5","6",11
"15066","Sabrie","F","5","6",11
"15086","Saxon","F","5","6",11
"15089","Seleah","F","5","6",11
"15096","Sevannah","F","5","6",11
"15100","Shaelan","F","5","6",11
"15108","Sherley","F","5","6",11
"15113","Similoluwa","F","5","6",11
"15118","Skyland","F","5","6",11
"15120","Sofiagrace","F","5","6",11
"15121","Sojourner","F","5","6",11
"15123","Sonakshi","F","5","6",11
"15135","Sukayna","F","5","6",11
"15136","Sukhman","F","5","6",11
"15142","Taige","F","5","6",11
"15151","Tayte","F","5","6",11
"15162","Torrin","F","5","6",11
"15178","Veralynn","F","5","6",11
"15179","Vicktoria","F","5","6",11
"15180","Victoriah","F","5","6",11
"15182","Vionna","F","5","6",11
"15195","Xaylee","F","5","6",11
"15200","Yahli","F","5","6",11
"15203","Yalissa","F","5","6",11
"15204","Yan","F","5","6",11
"15205","Yanel","F","5","6",11
"15211","Yatzari","F","5","6",11
"15223","Yvana","F","5","6",11
"15226","Zacari","F","5","6",11
"15233","Zakariya","F","5","6",11
"15234","Zakyia","F","5","6",11
"15257","Zitong","F","5","6",11
"15263","Zorina","F","5","6",11
"14169","Aaliyahrose","F","5","5",10
"14170","Aaliyiah","F","5","5",10
"14171","Aamanee","F","5","5",10
"14174","Aarilynn","F","5","5",10
"14179","Aaziyah","F","5","5",10
"14184","Abriela","F","5","5",10
"14186","Addileigh","F","5","5",10
"14187","Adelay","F","5","5",10
"14188","Adelaya","F","5","5",10
"14193","Adorable","F","5","5",10
"14196","Aelyn","F","5","5",10
"14200","Ahsoka","F","5","5",10
"14203","Aimen","F","5","5",10
"14205","Aishini","F","5","5",10
"14222","Alexx","F","5","5",10
"14223","Aleyla","F","5","5",10
"14232","Aloe","F","5","5",10
"14238","Amarylis","F","5","5",10
"14244","Amry","F","5","5",10
"14246","Amyrical","F","5","5",10
"14255","Anaston","F","5","5",10
"14256","Anayelli","F","5","5",10
"14257","Anayia","F","5","5",10
"14258","Anayra","F","5","5",10
"14261","Aneta","F","5","5",10
"14262","Angellica","F","5","5",10
"14266","Annalice","F","5","5",10
"14267","Annaliza","F","5","5",10
"14270","Anneth","F","5","5",10
"14273","Antonela","F","5","5",10
"14277","Aquinnah","F","5","5",10
"14281","Areana","F","5","5",10
"14282","Areebah","F","5","5",10
"14283","Areeya","F","5","5",10
"14290","Ariayah","F","5","5",10
"14291","Ariday","F","5","5",10
"14294","Arieya","F","5","5",10
"14296","Ariyiah","F","5","5",10
"14298","Arlenis","F","5","5",10
"14311","Atiyah","F","5","5",10
"14313","Aubriauna","F","5","5",10
"14318","Avabella","F","5","5",10
"14325","Averyonna","F","5","5",10
"14326","Aviary","F","5","5",10
"14327","Avin","F","5","5",10
"14334","Azalaya","F","5","5",10
"14336","Azani","F","5","5",10
"14339","Azeriah","F","5","5",10
"14343","Bailor","F","5","5",10
"14349","Berta","F","5","5",10
"14354","Bisma","F","5","5",10
"14358","Braniya","F","5","5",10
"14367","Breylynn","F","5","5",10
"14369","Brieann","F","5","5",10
"14372","Brittlyn","F","5","5",10
"14375","Brylyn","F","5","5",10
"14382","Callieann","F","5","5",10
"14384","Calyx","F","5","5",10
"14385","Cam","F","5","5",10
"14388","Cameo","F","5","5",10
"14391","Caselynn","F","5","5",10
"14392","Cassiana","F","5","5",10
"14394","Ceceilia","F","5","5",10
"14396","Ceili","F","5","5",10
"14397","Celaya","F","5","5",10
"14399","Charlet","F","5","5",10
"14400","Chenelle","F","5","5",10
"14402","Cielle","F","5","5",10
"14405","Claiborne","F","5","5",10
"14406","Clarajane","F","5","5",10
"14408","Clodagh","F","5","5",10
"14409","Corinthia","F","5","5",10
"14415","Cynia","F","5","5",10
"14416","Cyniyah","F","5","5",10
"14420","Dailani","F","5","5",10
"14422","Dailin","F","5","5",10
"14431","Danicka","F","5","5",10
"14433","Darilyn","F","5","5",10
"14435","Davonna","F","5","5",10
"14436","Dayle","F","5","5",10
"14443","Dela","F","5","5",10
"14447","Deloris","F","5","5",10
"14450","Demira","F","5","5",10
"14451","Demyah","F","5","5",10
"14452","Denaya","F","5","5",10
"14453","Denylah","F","5","5",10
"14459","Desiah","F","5","5",10
"14460","Desta","F","5","5",10
"14467","Dezaray","F","5","5",10
"14470","Doria","F","5","5",10
"14471","Dorie","F","5","5",10
"14472","Dylaney","F","5","5",10
"14478","Elilta","F","5","5",10
"14480","Elisiana","F","5","5",10
"14482","Elizabethrose","F","5","5",10
"14483","Elizebeth","F","5","5",10
"14493","Emalin","F","5","5",10
"14495","Emanii","F","5","5",10
"14506","Emyrson","F","5","5",10
"14508","Enisa","F","5","5",10
"14509","Enzley","F","5","5",10
"14510","Eric","F","5","5",10
"14523","Evgenia","F","5","5",10
"14526","Evon","F","5","5",10
"14534","Fabiha","F","5","5",10
"14538","Fayrouz","F","5","5",10
"14541","Fina","F","5","5",10
"14545","Fotini","F","5","5",10
"14553","Garner","F","5","5",10
"14554","Gavin","F","5","5",10
"14555","Genysis","F","5","5",10
"14570","Habon","F","5","5",10
"14571","Hadden","F","5","5",10
"14579","Havanah","F","5","5",10
"14582","Hayleen","F","5","5",10
"14584","Heartlyn","F","5","5",10
"14589","Hifza","F","5","5",10
"14591","Hinako","F","5","5",10
"14592","Hollyann","F","5","5",10
"14593","Huai","F","5","5",10
"14594","Idalis","F","5","5",10
"14596","Ijeoma","F","5","5",10
"14597","Ikhlaas","F","5","5",10
"14601","Iliya","F","5","5",10
"14602","Ilynn","F","5","5",10
"14608","Iqlas","F","5","5",10
"14609","Irah","F","5","5",10
"14622","Jady","F","5","5",10
"14629","Jakylee","F","5","5",10
"14632","Jalayiah","F","5","5",10
"14634","Jalin","F","5","5",10
"14635","Jamaiya","F","5","5",10
"14645","Jaria","F","5","5",10
"14646","Jarielis","F","5","5",10
"14655","Jaylyne","F","5","5",10
"14657","Jazzlene","F","5","5",10
"14660","Jedidiah","F","5","5",10
"14664","Jenelly","F","5","5",10
"14665","Jeniveve","F","5","5",10
"14667","Jermiah","F","5","5",10
"14668","Jernei","F","5","5",10
"14672","Jessly","F","5","5",10
"14673","Jevaeh","F","5","5",10
"14684","Joellie","F","5","5",10
"14685","Joliene","F","5","5",10
"14687","Joplyn","F","5","5",10
"14690","Judie","F","5","5",10
"14696","Justyne","F","5","5",10
"14702","Kahmila","F","5","5",10
"14707","Kaizleigh","F","5","5",10
"14712","Kameria","F","5","5",10
"14713","Kamorra","F","5","5",10
"14722","Kariya","F","5","5",10
"14723","Karlena","F","5","5",10
"14727","Kataliyah","F","5","5",10
"14728","Katielynn","F","5","5",10
"14733","Keiasia","F","5","5",10
"14736","Kemonie","F","5","5",10
"14737","Kenasia","F","5","5",10
"14748","Khamil","F","5","5",10
"14754","Kimyah","F","5","5",10
"14756","Kinlie","F","5","5",10
"14757","Kinly","F","5","5",10
"14758","Kinzli","F","5","5",10
"14760","Kiowa","F","5","5",10
"14766","Kopelyn","F","5","5",10
"14769","Korilynn","F","5","5",10
"14770","Korrin","F","5","5",10
"14783","Lamyiah","F","5","5",10
"14786","Lashea","F","5","5",10
"14788","Latonya","F","5","5",10
"14794","Leamarie","F","5","5",10
"14795","Leamsi","F","5","5",10
"14798","Leelyn","F","5","5",10
"14800","Lehua","F","5","5",10
"14802","Leonella","F","5","5",10
"14804","Leveah","F","5","5",10
"14809","Liezel","F","5","5",10
"14810","Lilas","F","5","5",10
"14815","Lilliemae","F","5","5",10
"14824","Lovisa","F","5","5",10
"14825","Loyaltee","F","5","5",10
"14829","Lulani","F","5","5",10
"14832","Luziana","F","5","5",10
"14842","Madielyn","F","5","5",10
"14843","Madrid","F","5","5",10
"14845","Maesie","F","5","5",10
"14846","Magdeline","F","5","5",10
"14850","Mairely","F","5","5",10
"14852","Maisee","F","5","5",10
"14853","Maizley","F","5","5",10
"14854","Makelle","F","5","5",10
"14861","Malila","F","5","5",10
"14862","Maly","F","5","5",10
"14865","Mandalyn","F","5","5",10
"14880","Martavia","F","5","5",10
"14881","Maryel","F","5","5",10
"14894","Mehjabeen","F","5","5",10
"14900","Meria","F","5","5",10
"14901","Merilyn","F","5","5",10
"14902","Michella","F","5","5",10
"14903","Mieko","F","5","5",10
"14904","Mikaelyn","F","5","5",10
"14922","Muska","F","5","5",10
"14926","Myna","F","5","5",10
"14931","Nakaiya","F","5","5",10
"14935","Namirah","F","5","5",10
"14937","Narely","F","5","5",10
"14939","Nashira","F","5","5",10
"14943","Nation","F","5","5",10
"14944","Navira","F","5","5",10
"14946","Neelah","F","5","5",10
"14947","Neemah","F","5","5",10
"14953","Neliah","F","5","5",10
"14955","Nelya","F","5","5",10
"14960","Nicha","F","5","5",10
"14961","Nicholette","F","5","5",10
"14962","Nieves","F","5","5",10
"14966","Nino","F","5","5",10
"14968","Nneka","F","5","5",10
"14969","Noralynn","F","5","5",10
"14981","Oliviya","F","5","5",10
"14982","Oluwadara","F","5","5",10
"14983","Oluwadunmininu","F","5","5",10
"14985","Oluwaseun","F","5","5",10
"14992","Palin","F","5","5",10
"15003","Praylee","F","5","5",10
"15004","Prescott","F","5","5",10
"15005","Prisma","F","5","5",10
"15008","Quinnleigh","F","5","5",10
"15010","Raegin","F","5","5",10
"15011","Raeli","F","5","5",10
"15019","Reality","F","5","5",10
"15021","Reanne","F","5","5",10
"15026","Reizy","F","5","5",10
"15032","Reyanna","F","5","5",10
"15037","Rinna","F","5","5",10
"15039","Riplee","F","5","5",10
"15040","Rithvika","F","5","5",10
"15042","Roda","F","5","5",10
"15046","Romaisa","F","5","5",10
"15047","Ronika","F","5","5",10
"15053","Rosslynn","F","5","5",10
"15056","Rozella","F","5","5",10
"15062","Ryia","F","5","5",10
"15065","Saamiya","F","5","5",10
"15067","Sadeem","F","5","5",10
"15069","Saelah","F","5","5",10
"15070","Sahib","F","5","5",10
"15071","Sakeenah","F","5","5",10
"15073","Samanda","F","5","5",10
"15075","Samay","F","5","5",10
"15076","San","F","5","5",10
"15079","Saniyyah","F","5","5",10
"15080","Santiana","F","5","5",10
"15082","Sareya","F","5","5",10
"15084","Saumya","F","5","5",10
"15090","Selima","F","5","5",10
"15092","Seniya","F","5","5",10
"15098","Seynabou","F","5","5",10
"15106","Shayanna","F","5","5",10
"15107","Shelsey","F","5","5",10
"15109","Shianna","F","5","5",10
"15116","Skilyn","F","5","5",10
"15119","Skylei","F","5","5",10
"15124","Sonaya","F","5","5",10
"15125","Soniah","F","5","5",10
"15126","Sophonie","F","5","5",10
"15127","Sravya","F","5","5",10
"15128","Sreenidhi","F","5","5",10
"15130","Stoney","F","5","5",10
"15132","Sudiksha","F","5","5",10
"15133","Sueann","F","5","5",10
"15134","Suetta","F","5","5",10
"15137","Sumedha","F","5","5",10
"15143","Talianna","F","5","5",10
"15144","Tallyn","F","5","5",10
"15149","Tauri","F","5","5",10
"15152","Teagann","F","5","5",10
"15153","Teela","F","5","5",10
"15158","Tiernan","F","5","5",10
"15159","Timothy","F","5","5",10
"15166","Trillium","F","5","5",10
"15167","Trinley","F","5","5",10
"15169","Troian","F","5","5",10
"15170","Tye","F","5","5",10
"15173","Vaiga","F","5","5",10
"15174","Vaishvi","F","5","5",10
"15175","Vanisha","F","5","5",10
"15183","Viviani","F","5","5",10
"15186","Waylyn","F","5","5",10
"15190","Wilmary","F","5","5",10
"15192","Xaela","F","5","5",10
"15193","Xaelah","F","5","5",10
"15199","Yaheli","F","5","5",10
"15201","Yalaina","F","5","5",10
"15206","Yanelie","F","5","5",10
"15208","Yarelin","F","5","5",10
"15212","Yazbeth","F","5","5",10
"15217","Yinuo","F","5","5",10
"15229","Zafiro","F","5","5",10
"15230","Zahniya","F","5","5",10
"15231","Zahriyah","F","5","5",10
"15232","Zaide","F","5","5",10
"15235","Zamoni","F","5","5",10
"15239","Zayleah","F","5","5",10
"15244","Zela","F","5","5",10
"15245","Zelene","F","5","5",10
"15247","Zennia","F","5","5",10
"15253","Zikra","F","5","5",10
"15255","Ziniyah","F","5","5",10
"15256","Zirah","F","5","5",10
"15259","Zizi","F","5","5",10
"15260","Zohara","F","5","5",10
"15266","Zuriya","F","5","5",10
